siruta,jud_code,jud_lbl,uat_lbl,total_voturi,voturi_ponta,voturi_iohannis,procent_ponta,procent_iohannis,castigator
1151,AB,ALBA,ABRUD,2952,1457,1495,49.35,50.64,1
1213,AB,ALBA,AIUD,14330,5548,8782,38.71,61.28,1
1017,AB,ALBA,ALBA IULIA,41724,11906,29818,28.53,71.46,1
2130,AB,ALBA,ALBAC,1212,323,889,26.65,73.34,1
2309,AB,ALBA,ALMAȘU MARE,809,224,585,27.68,72.31,1
2381,AB,ALBA,ARIEȘENI,1123,472,651,42.03,57.96,1
2577,AB,ALBA,AVRAM IANCU,919,161,758,17.51,82.48,1
2915,AB,ALBA,BAIA DE ARIEȘ,2070,883,1187,42.65,57.34,1
2988,AB,ALBA,BERGHIN,1085,242,843,22.30,77.69,1
3039,AB,ALBA,BISTRA,2377,796,1581,33.48,66.51,1
1348,AB,ALBA,BLAJ,10763,2827,7936,26.26,73.73,1
3397,AB,ALBA,BLANDIANA,584,145,439,24.82,75.17,1
9026,AB,ALBA,BUCERDEA GRÂNOASĂ,1405,329,1076,23.41,76.58,1
3459,AB,ALBA,BUCIUM,913,473,440,51.80,48.19,2
4106,AB,ALBA,CÂLNIC,1011,340,671,33.63,66.36,1
1455,AB,ALBA,CÂMPENI,4877,1881,2996,38.56,61.43,1
3761,AB,ALBA,CENADE,518,83,435,16.02,83.97,1
3805,AB,ALBA,CERGĂU,1001,195,806,19.48,80.51,1
3841,AB,ALBA,CERU-BĂCĂINȚI,188,65,123,34.57,65.42,1
3958,AB,ALBA,CETATEA DE BALTĂ,1337,406,931,30.36,69.63,1
1071,AB,ALBA,CIUGUD,2041,824,1217,40.37,59.62,1
4008,AB,ALBA,CIURULEASA,677,295,382,43.57,56.42,1
4188,AB,ALBA,CRĂCIUNELU DE JOS,1229,301,928,24.49,75.50,1
4142,AB,ALBA,CRICĂU,1213,343,870,28.27,71.72,1
1696,AB,ALBA,CUGIR,13283,5444,7839,40.98,59.01,1
9019,AB,ALBA,CUT,752,225,527,29.92,70.07,1
4240,AB,ALBA,DAIA ROMÂNĂ,1542,238,1304,15.43,84.56,1
4268,AB,ALBA,DOȘTAT,584,139,445,23.80,76.19,1
4302,AB,ALBA,FĂRĂU,903,234,669,25.91,74.08,1
4366,AB,ALBA,GALDA DE JOS,2451,576,1875,23.50,76.49,1
4482,AB,ALBA,GÂRBOVA,1102,234,868,21.23,78.76,1
4525,AB,ALBA,GÂRDA DE SUS,1005,226,779,22.48,77.51,1
4703,AB,ALBA,HOPÂRTA,697,144,553,20.65,79.34,1
4767,AB,ALBA,HOREA,1307,348,959,26.62,73.37,1
4927,AB,ALBA,IGHIU,3596,865,2731,24.05,75.94,1
4981,AB,ALBA,ÎNTREGALDE,387,80,307,20.67,79.32,1
5103,AB,ALBA,JIDVEI,2668,502,2166,18.81,81.18,1
5167,AB,ALBA,LIVEZILE,811,263,548,32.42,67.57,1
5210,AB,ALBA,LOPADEA NOUĂ,1583,262,1321,16.55,83.44,1
5309,AB,ALBA,LUNCA MUREȘULUI,1258,276,982,21.93,78.06,1
5336,AB,ALBA,LUPȘA,1737,735,1002,42.31,57.68,1
5577,AB,ALBA,METEȘ,1648,622,1026,37.74,62.25,1
5700,AB,ALBA,MIHALȚ,2140,823,1317,38.45,61.54,1
5755,AB,ALBA,MIRĂSLĂU,1193,295,898,24.72,75.27,1
5826,AB,ALBA,MOGOȘ,415,124,291,29.87,70.12,1
6048,AB,ALBA,NOȘLAC,930,215,715,23.11,76.88,1
1794,AB,ALBA,OCNA MUREȘ,7121,2354,4767,33.05,66.94,1
6119,AB,ALBA,OCOLIȘ,431,112,319,25.98,74.01,1
6164,AB,ALBA,OHABA,490,160,330,32.65,67.34,1
6217,AB,ALBA,PIANU,1804,332,1472,18.40,81.59,1
6271,AB,ALBA,POIANA VADULUI,485,140,345,28.86,71.13,1
6397,AB,ALBA,PONOR,365,155,210,42.46,57.53,1
6468,AB,ALBA,POȘAGA,648,161,487,24.84,75.15,1
6547,AB,ALBA,RĂDEȘTI,819,265,554,32.35,67.64,1
6627,AB,ALBA,RÂMEȚ,429,204,225,47.55,52.44,1
6592,AB,ALBA,RIMETEA,582,60,522,10.30,89.69,1
6930,AB,ALBA,ROȘIA DE SECAȘ,845,240,605,28.40,71.59,1
6761,AB,ALBA,ROȘIA MONTANĂ,1660,690,970,41.56,58.43,1
6976,AB,ALBA,SĂLCIUA,919,322,597,35.03,64.96,1
7044,AB,ALBA,SĂLIȘTEA,1507,279,1228,18.51,81.48,1
7348,AB,ALBA,SÂNCEL,1490,340,1150,22.81,77.18,1
7384,AB,ALBA,SÂNTIMBRU,1633,456,1177,27.92,72.07,1
7099,AB,ALBA,SĂSCIORI,3206,457,2749,14.25,85.74,1
7197,AB,ALBA,SCĂRIȘOARA,954,265,689,27.77,72.22,1
1874,AB,ALBA,SEBEȘ,16390,3999,12391,24.39,75.60,1
7810,AB,ALBA,ȘIBOT,1436,442,994,30.77,69.22,1
7446,AB,ALBA,SOHODOL,920,294,626,31.95,68.04,1
7865,AB,ALBA,ȘONA,2202,449,1753,20.39,79.60,1
7945,AB,ALBA,ȘPRING,1499,366,1133,24.41,75.58,1
7767,AB,ALBA,STREMȚ,1561,693,868,44.39,55.60,1
8014,AB,ALBA,ȘUGAG,1774,153,1621,8.62,91.37,1
8096,AB,ALBA,TEIUȘ,3890,1578,2312,40.56,59.43,1
8158,AB,ALBA,UNIREA,2511,904,1607,36.00,63.99,1
8229,AB,ALBA,VADU MOȚILOR,686,153,533,22.30,77.69,1
8354,AB,ALBA,VALEA LUNGĂ,1756,440,1316,25.05,74.94,1
8425,AB,ALBA,VIDRA,937,308,629,32.87,67.12,1
8826,AB,ALBA,VINȚU DE JOS,2934,862,2072,29.37,70.62,1
1936,AB,ALBA,ZLATNA,4539,1853,2686,40.82,59.17,1
9743,AR,ARAD,ALMAȘ,1477,563,914,38.11,61.88,1
9798,AR,ARAD,APATEU,1731,636,1095,36.74,63.25,1
9262,AR,ARAD,ARAD,93857,30988,62869,33.01,66.98,1
9832,AR,ARAD,ARCHIȘ,927,478,449,51.56,48.43,2
10051,AR,ARAD,BÂRSA,1121,450,671,40.14,59.85,1
10104,AR,ARAD,BÂRZAVA,1628,829,799,50.92,49.07,2
9887,AR,ARAD,BATA,596,214,382,35.90,64.09,1
9930,AR,ARAD,BELIU,1787,723,1064,40.45,59.54,1
10006,AR,ARAD,BIRCHIȘ,940,384,556,40.85,59.14,1
10195,AR,ARAD,BOCSIG,1704,932,772,54.69,45.30,2
10239,AR,ARAD,BRAZII,714,289,425,40.47,59.52,1
10293,AR,ARAD,BUTENI,1878,646,1232,34.39,65.60,1
10346,AR,ARAD,CĂRAND,621,303,318,48.79,51.20,1
10373,AR,ARAD,CERMEI,1285,618,667,48.09,51.90,1
10417,AR,ARAD,CHISINDIA,734,272,462,37.05,62.94,1
9459,AR,ARAD,CHIȘINEU-CRIȘ,4312,1798,2514,41.69,58.30,1
10453,AR,ARAD,CONOP,1240,515,725,41.53,58.46,1
10514,AR,ARAD,COVĂSINȚ,1013,289,724,28.52,71.47,1
10532,AR,ARAD,CRAIVA,1631,557,1074,34.15,65.84,1
9495,AR,ARAD,CURTICI,3500,870,2630,24.85,75.14,1
10649,AR,ARAD,DEZNA,926,472,454,50.97,49.02,2
10701,AR,ARAD,DIECI,1120,545,575,48.66,51.33,1
12912,AR,ARAD,DOROBANȚI,759,76,683,10.01,89.98,1
9280,AR,ARAD,FÂNTÂNELE,1872,776,1096,41.45,58.54,1
10827,AR,ARAD,FELNAC,1596,813,783,50.93,49.06,2
12920,AR,ARAD,FRUMUȘENI,1329,379,950,28.51,71.48,1
10872,AR,ARAD,GHIOROC,2097,705,1392,33.61,66.38,1
10916,AR,ARAD,GRĂNICERI,1147,378,769,32.95,67.04,1
10943,AR,ARAD,GURAHONȚ,2377,877,1500,36.89,63.10,1
11174,AR,ARAD,HĂLMĂGEL,785,411,374,52.35,47.64,2
11058,AR,ARAD,HĂLMAGIU,1685,689,996,40.89,59.10,1
11236,AR,ARAD,HĂȘMAȘ,838,357,481,42.60,57.39,1
11307,AR,ARAD,IGNEȘTI,438,173,265,39.49,60.50,1
9538,AR,ARAD,INEU,5254,1901,3353,36.18,63.81,1
11352,AR,ARAD,IRATOȘU,1115,211,904,18.92,81.07,1
9574,AR,ARAD,LIPOVA,5964,2309,3655,38.71,61.28,1
9333,AR,ARAD,LIVADA,1723,497,1226,28.84,71.15,1
11398,AR,ARAD,MACEA,2851,1024,1827,35.91,64.08,1
11423,AR,ARAD,MIȘCA,1572,713,859,45.35,54.64,1
11478,AR,ARAD,MONEASA,870,402,468,46.20,53.79,1
9627,AR,ARAD,NĂDLAC,4037,866,3171,21.45,78.54,1
11502,AR,ARAD,OLARI,903,312,591,34.55,65.44,1
9654,AR,ARAD,PÂNCOTA,3362,980,2382,29.14,70.85,1
11539,AR,ARAD,PĂULIȘ,2300,616,1684,26.78,73.21,1
11584,AR,ARAD,PECICA,6637,1689,4948,25.44,74.55,1
11637,AR,ARAD,PEREGU MARE,753,141,612,18.72,81.27,1
11664,AR,ARAD,PETRIȘ,826,309,517,37.40,62.59,1
11735,AR,ARAD,PILU,1075,445,630,41.39,58.60,1
11762,AR,ARAD,PLEȘCUȚA,704,297,407,42.18,57.81,1
12144,AR,ARAD,ȘAGU,2041,547,1494,26.80,73.19,1
12091,AR,ARAD,SÂNTANA,5725,2151,3574,37.57,62.42,1
11842,AR,ARAD,SĂVÂRȘIN,1858,903,955,48.60,51.39,1
9690,AR,ARAD,SEBIȘ,3312,1038,2274,31.34,68.65,1
11940,AR,ARAD,SECUSIGIU,2602,938,1664,36.04,63.95,1
12206,AR,ARAD,ȘEITIN,1495,580,915,38.79,61.20,1
11995,AR,ARAD,SELEUȘ,1673,404,1269,24.14,75.85,1
12037,AR,ARAD,SEMLAC,1641,450,1191,27.42,72.57,1
12224,AR,ARAD,ȘEPREUȘ,1091,462,629,42.34,57.65,1
12242,AR,ARAD,ȘICULA,2054,848,1206,41.28,58.71,1
12288,AR,ARAD,ȘILINDIA,534,151,383,28.27,71.72,1
12340,AR,ARAD,ȘIMAND,1952,811,1141,41.54,58.45,1
12055,AR,ARAD,SINTEA MARE,1585,459,1126,28.95,71.04,1
12368,AR,ARAD,ȘIRIA,3537,1215,2322,34.35,65.64,1
12402,AR,ARAD,ȘIȘTAROVĂȚ,195,105,90,53.84,46.15,2
12126,AR,ARAD,SOCODOR,1424,460,964,32.30,67.69,1
9360,AR,ARAD,ȘOFRONEA,1559,492,1067,31.55,68.44,1
12509,AR,ARAD,TÂRNOVA,3660,1163,2497,31.77,68.22,1
12457,AR,ARAD,TAUȚ,1023,447,576,43.69,56.30,1
10765,AR,ARAD,USUSĂU,709,262,447,36.95,63.04,1
12572,AR,ARAD,VĂRĂDIA DE MUREȘ,987,398,589,40.32,59.67,1
12689,AR,ARAD,VÂRFURILE,1505,606,899,40.26,59.73,1
12643,AR,ARAD,VINGA,3016,853,2163,28.28,71.71,1
9397,AR,ARAD,VLADIMIRESCU,5950,1659,4291,27.88,72.11,1
12778,AR,ARAD,ZĂBRANI,2134,673,1461,31.53,68.46,1
12938,AR,ARAD,ZĂDĂRENI,1327,414,913,31.19,68.80,1
12812,AR,ARAD,ZĂRAND,1303,616,687,47.27,52.72,1
12849,AR,ARAD,ZERIND,552,96,456,17.39,82.60,1
12876,AR,ARAD,ZIMANDU NOU,2576,494,2082,19.17,80.82,1
13819,AG,ARGEȘ,ALBEȘTII DE ARGEȘ,3073,1679,1394,54.63,45.36,2
13891,AG,ARGEȘ,ALBEȘTII DE MUSCEL,988,490,498,49.59,50.40,1
13935,AG,ARGEȘ,ALBOTA,2262,1486,776,65.69,34.30,2
13999,AG,ARGEȘ,ANINOASA,1932,1377,555,71.27,28.72,2
14049,AG,ARGEȘ,AREFU,1395,659,736,47.24,52.75,1
14085,AG,ARGEȘ,BĂBANA,1807,1238,569,68.51,31.48,2
14165,AG,ARGEȘ,BĂICULEȘTI,3192,1991,1201,62.37,37.62,2
14272,AG,ARGEȘ,BĂLILEȘTI,2314,1577,737,68.15,31.84,2
14450,AG,ARGEȘ,BÂRLA,2013,1248,765,61.99,38.00,2
13187,AG,ARGEȘ,BASCOV,5916,3408,2508,57.60,42.39,2
14352,AG,ARGEȘ,BELEȚI-NEGREȘTI,1059,602,457,56.84,43.15,2
14405,AG,ARGEȘ,BEREVOEȘTI,1705,1215,490,71.26,28.73,2
14584,AG,ARGEȘ,BOGAȚI,2559,1564,995,61.11,38.88,2
14673,AG,ARGEȘ,BOTENI,1396,939,457,67.26,32.73,2
14726,AG,ARGEȘ,BOȚEȘTI,752,394,358,52.39,47.60,2
13276,AG,ARGEȘ,BRADU,3940,2377,1563,60.32,39.67,2
14753,AG,ARGEȘ,BRĂDULEȚ,1167,774,393,66.32,33.67,2
14851,AG,ARGEȘ,BUDEASA,2199,1404,795,63.84,36.15,2
14922,AG,ARGEȘ,BUGHEA DE JOS,1504,838,666,55.71,44.28,2
20063,AG,ARGEȘ,BUGHEA DE SUS,1526,785,741,51.44,48.55,2
14940,AG,ARGEȘ,BUZOEȘTI,2629,1759,870,66.90,33.09,2
15064,AG,ARGEȘ,CĂLDĂRARU,1192,859,333,72.06,27.93,2
15108,AG,ARGEȘ,CĂLINEȘTI,5327,3359,1968,63.05,36.94,2
13490,AG,ARGEȘ,CÂMPULUNG,18392,9670,8722,52.57,47.42,2
15233,AG,ARGEȘ,CĂTEASCA,2031,1273,758,62.67,37.32,2
15313,AG,ARGEȘ,CEPARI,1177,628,549,53.35,46.64,2
15402,AG,ARGEȘ,CETĂȚENI,1439,853,586,59.27,40.72,2
15448,AG,ARGEȘ,CICĂNEȘTI,1194,783,411,65.57,34.42,2
15493,AG,ARGEȘ,CIOFRÂNGENI,1364,799,565,58.57,41.42,2
15554,AG,ARGEȘ,CIOMĂGEȘTI,728,398,330,54.67,45.32,2
15652,AG,ARGEȘ,COCU,1258,907,351,72.09,27.90,2
15741,AG,ARGEȘ,CORBENI,2797,1618,1179,57.84,42.15,2
15830,AG,ARGEȘ,CORBI,2389,1182,1207,49.47,50.52,1
15901,AG,ARGEȘ,COȘEȘTI,2726,1930,796,70.79,29.20,2
13668,AG,ARGEȘ,COSTEȘTI,5346,3067,2279,57.36,42.63,2
15983,AG,ARGEȘ,COTMEANA,961,596,365,62.01,37.98,2
16132,AG,ARGEȘ,CUCA,1252,878,374,70.12,29.87,2
13622,AG,ARGEȘ,CURTEA DE ARGEȘ,16749,8805,7944,52.57,47.42,2
16329,AG,ARGEȘ,DÂMBOVICIOARA,759,387,372,50.98,49.01,2
16365,AG,ARGEȘ,DÂRMĂNEȘTI,1894,1317,577,69.53,30.46,2
16285,AG,ARGEȘ,DAVIDEȘTI,1484,1138,346,76.68,23.31,2
16427,AG,ARGEȘ,DOBREȘTI,1017,656,361,64.50,35.49,2
16454,AG,ARGEȘ,DOMNEȘTI,1954,1293,661,66.17,33.82,2
16506,AG,ARGEȘ,DRĂGANU,1093,678,415,62.03,37.96,2
16472,AG,ARGEȘ,DRAGOSLAVELE,1459,855,604,58.60,41.39,2
16551,AG,ARGEȘ,GODENI,1685,1156,529,68.60,31.39,2
16613,AG,ARGEȘ,HÂRSEȘTI,1214,899,315,74.05,25.94,2
16659,AG,ARGEȘ,HÂRTIEȘTI,1206,928,278,76.94,23.05,2
16739,AG,ARGEȘ,IZVORU,964,697,267,72.30,27.69,2
16757,AG,ARGEȘ,LEORDENI,3096,2150,946,69.44,30.55,2
16908,AG,ARGEȘ,LEREȘTI,2708,1736,972,64.10,35.89,2
16944,AG,ARGEȘ,LUNCA CORBULUI,1525,921,604,60.39,39.60,2
17049,AG,ARGEȘ,MĂLURENI,2257,1583,674,70.13,29.86,2
13365,AG,ARGEȘ,MĂRĂCINENI,2779,1735,1044,62.43,37.56,2
17101,AG,ARGEȘ,MERIȘANI,2191,1444,747,65.90,34.09,2
17209,AG,ARGEȘ,MICEȘTI,2164,1320,844,60.99,39.00,2
17254,AG,ARGEȘ,MIHĂEȘTI,3176,2216,960,69.77,30.22,2
17334,AG,ARGEȘ,MIOARELE,920,537,383,58.36,41.63,2
13301,AG,ARGEȘ,MIOVENI,19623,11727,7896,59.76,40.23,2
17398,AG,ARGEȘ,MIROȘI,1215,916,299,75.39,24.60,2
17423,AG,ARGEȘ,MORĂREȘTI,1054,574,480,54.45,45.54,2
17496,AG,ARGEȘ,MOȘOAIA,3047,1782,1265,58.48,41.51,2
17575,AG,ARGEȘ,MOZĂCENI,1095,811,284,74.06,25.93,2
17619,AG,ARGEȘ,MUȘĂTEȘTI,2098,1402,696,66.82,33.17,2
17726,AG,ARGEȘ,NEGRAȘI,1168,837,331,71.66,28.33,2
17771,AG,ARGEȘ,NUCȘOARA,893,599,294,67.07,32.92,2
17824,AG,ARGEȘ,OARJA,1578,922,656,58.42,41.57,2
17851,AG,ARGEȘ,PIETROȘANI,3029,2099,930,69.29,30.70,2
13169,AG,ARGEȘ,PITEȘTI,94625,50983,43642,53.87,46.12,2
18028,AG,ARGEȘ,POIANA LACULUI,3378,1818,1560,53.81,46.18,2
17913,AG,ARGEȘ,POIENARII DE ARGEȘ,657,275,382,41.85,58.14,1
17968,AG,ARGEȘ,POIENARII DE MUSCEL,1607,1012,595,62.97,37.02,2
18162,AG,ARGEȘ,POPEȘTI,1071,840,231,78.43,21.56,2
18242,AG,ARGEȘ,PRIBOIENI,2113,1414,699,66.91,33.08,2
20048,AG,ARGEȘ,RÂCA,776,695,81,89.56,10.43,2
18331,AG,ARGEȘ,RĂTEȘTI,1552,1071,481,69.00,30.99,2
18411,AG,ARGEȘ,RECEA,1494,1032,462,69.07,30.92,2
18475,AG,ARGEȘ,ROCIU,1811,1457,354,80.45,19.54,2
18527,AG,ARGEȘ,RUCĂR,3756,1987,1769,52.90,47.09,2
18554,AG,ARGEȘ,SĂLĂTRUCU,1112,598,514,53.77,46.22,2
18581,AG,ARGEȘ,SĂPATA,1121,735,386,65.56,34.43,2
18670,AG,ARGEȘ,SCHITU GOLEȘTI,2376,1580,796,66.49,33.50,2
18741,AG,ARGEȘ,SLOBOZIA,2161,1403,758,64.92,35.07,2
18778,AG,ARGEȘ,STÂLPENI,2954,2181,773,73.83,26.16,2
19114,AG,ARGEȘ,ȘTEFAN CEL MARE,1180,860,320,72.88,27.11,2
13392,AG,ARGEȘ,ȘTEFĂNEȘTI,7823,4174,3649,53.35,46.64,2
18858,AG,ARGEȘ,STOENEȘTI,2350,1355,995,57.65,42.34,2
18938,AG,ARGEȘ,STOLNICI,1521,1086,435,71.40,28.59,2
19141,AG,ARGEȘ,ȘUICI,1404,833,571,59.33,40.66,2
19007,AG,ARGEȘ,SUSENI,1650,939,711,56.90,43.09,2
19212,AG,ARGEȘ,TEIU,749,567,182,75.70,24.29,2
19249,AG,ARGEȘ,TIGVENI,1588,1057,531,66.56,33.43,2
19338,AG,ARGEȘ,ȚIȚEȘTI,2283,1563,720,68.46,31.53,2
13757,AG,ARGEȘ,TOPOLOVENI,5390,2970,2420,55.10,44.89,2
19392,AG,ARGEȘ,UDA,1225,887,338,72.40,27.59,2
19560,AG,ARGEȘ,UNGHENI,1627,1260,367,77.44,22.55,2
19631,AG,ARGEȘ,VALEA DANULUI,1718,897,821,52.21,47.78,2
19695,AG,ARGEȘ,VALEA IAȘULUI,1541,844,697,54.76,45.23,2
13524,AG,ARGEȘ,VALEA MARE PRAVĂȚ,2290,1197,1093,52.27,47.72,2
19793,AG,ARGEȘ,VEDEA,2204,1521,683,69.01,30.98,2
19999,AG,ARGEȘ,VLĂDEȘTI,1631,1166,465,71.48,28.51,2
20055,AG,ARGEȘ,VULTUREȘTI,1487,1070,417,71.95,28.04,2
21007,BC,BACĂU,AGĂȘ,2631,1558,1073,59.21,40.78,2
21098,BC,BACĂU,ARDEOANI,1226,860,366,70.14,29.85,2
21123,BC,BACĂU,ASĂU,3099,2042,1057,65.89,34.10,2
20297,BC,BACĂU,BACĂU,87718,36449,51269,41.55,58.44,1
21196,BC,BACĂU,BALCANI,3315,2163,1152,65.24,34.75,2
21454,BC,BACĂU,BÂRSĂNEȘTI,2201,1334,867,60.60,39.39,2
21249,BC,BACĂU,BEREȘTI-BISTRIȚA,1139,775,364,68.04,31.95,2
21338,BC,BACĂU,BEREȘTI-TAZLĂU,2760,2181,579,79.02,20.97,2
21418,BC,BACĂU,BERZUNȚI,2162,1582,580,73.17,26.82,2
21506,BC,BACĂU,BLĂGEȘTI,2793,1850,943,66.23,33.76,2
21560,BC,BACĂU,BOGDĂNEȘTI,1310,814,496,62.13,37.86,2
21597,BC,BACĂU,BRUSTUROASA,1565,1010,555,64.53,35.46,2
26338,BC,BACĂU,BUCIUMI,1593,1180,413,74.07,25.92,2
21668,BC,BACĂU,BUHOCI,1953,701,1252,35.89,64.10,1
20778,BC,BACĂU,BUHUȘI,7837,4540,3297,57.93,42.06,2
21757,BC,BACĂU,CĂIUȚI,2621,1561,1060,59.55,40.44,2
21720,BC,BACĂU,CAȘIN,1706,885,821,51.87,48.12,2
21855,BC,BACĂU,CLEJA,2485,809,1676,32.55,67.44,1
21891,BC,BACĂU,COLONEȘTI,1039,804,235,77.38,22.61,2
20821,BC,BACĂU,COMĂNEȘTI,10596,6089,4507,57.46,42.53,2
21971,BC,BACĂU,CORBASCA,1591,953,638,59.89,40.10,2
22059,BC,BACĂU,COȚOFĂNEȘTI,1751,1312,439,74.92,25.07,2
22111,BC,BACĂU,DĂMIENEȘTI,908,628,280,69.16,30.83,2
22166,BC,BACĂU,DĂRMĂNEȘTI,6594,4023,2571,61.01,38.98,2
22237,BC,BACĂU,DEALU MORII,1583,1072,511,67.71,32.28,2
22380,BC,BACĂU,DOFTEANA,5017,3046,1971,60.71,39.28,2
22460,BC,BACĂU,FARAOANI,2077,799,1278,38.46,61.53,1
22488,BC,BACĂU,FILIPENI,1103,681,422,61.74,38.25,2
22576,BC,BACĂU,FILIPEȘTI,2286,1284,1002,56.16,43.83,2
22665,BC,BACĂU,GĂICEANA,1527,997,530,65.29,34.70,2
22781,BC,BACĂU,GÂRLENI,2520,929,1591,36.86,63.13,1
22718,BC,BACĂU,GHIMEȘ-FĂGET,2106,616,1490,29.24,70.75,1
26346,BC,BACĂU,GIOSENI,1564,782,782,50.00,50.00,2
22834,BC,BACĂU,GLĂVĂNEȘTI,1588,1121,467,70.59,29.40,2
20607,BC,BACĂU,GURA VĂII,2322,1301,1021,56.02,43.97,2
22898,BC,BACĂU,HELEGIU,2790,1776,1014,63.65,36.34,2
20313,BC,BACĂU,HEMEIUȘ,2528,875,1653,34.61,65.38,1
22941,BC,BACĂU,HORGEȘTI,1979,1426,553,72.05,27.94,2
23047,BC,BACĂU,HURUIEȘTI,1313,954,359,72.65,27.34,2
26379,BC,BACĂU,ITEȘTI,865,404,461,46.70,53.29,1
23127,BC,BACĂU,IZVORU BERHECIULUI,793,436,357,54.98,45.01,2
20359,BC,BACĂU,LETEA VECHE,3918,2092,1826,53.39,46.60,2
23207,BC,BACĂU,LIPOVA,1453,1131,322,77.83,22.16,2
23289,BC,BACĂU,LIVEZI,2197,1492,705,67.91,32.08,2
23350,BC,BACĂU,LUIZI-CĂLUGĂRA,1767,617,1150,34.91,65.08,1
23387,BC,BACĂU,MĂGIREȘTI,2009,764,1245,38.02,61.97,1
20411,BC,BACĂU,MĂGURA,2348,884,1464,37.64,62.35,1
23449,BC,BACĂU,MĂNĂSTIREA CAȘIN,2323,1295,1028,55.74,44.25,2
20466,BC,BACĂU,MĂRGINENI,4386,2194,2192,50.02,49.97,2
20876,BC,BACĂU,MOINEȘTI,11414,6346,5068,55.59,44.40,2
23494,BC,BACĂU,MOTOȘENI,1890,1429,461,75.60,24.39,2
23644,BC,BACĂU,NEGRI,1192,815,377,68.37,31.62,2
23715,BC,BACĂU,NICOLAE BĂLCESCU,3725,1467,2258,39.38,60.61,1
26353,BC,BACĂU,ODOBEȘTI,1159,796,363,68.67,31.32,2
23797,BC,BACĂU,OITUZ,3990,2425,1565,60.77,39.22,2
23868,BC,BACĂU,ONCEȘTI,841,424,417,50.41,49.58,2
20563,BC,BACĂU,ONEȘTI,23296,12937,10359,55.53,44.46,2
23948,BC,BACĂU,ORBENI,1682,1028,654,61.11,38.88,2
23975,BC,BACĂU,PALANCA,1748,1289,459,73.74,26.25,2
24187,BC,BACĂU,PÂNCEȘTI,1585,930,655,58.67,41.32,2
24034,BC,BACĂU,PARAVA,1266,787,479,62.16,37.83,2
24276,BC,BACĂU,PÂRGĂREȘTI,1786,980,806,54.87,45.12,2
24089,BC,BACĂU,PARINCEA,1584,823,761,51.95,48.04,2
24338,BC,BACĂU,PÂRJOL,2765,1729,1036,62.53,37.46,2
24427,BC,BACĂU,PLOPANA,1596,1233,363,77.25,22.74,2
24524,BC,BACĂU,PODU TURCULUI,2645,1700,945,64.27,35.72,2
24631,BC,BACĂU,PODURI,3467,2060,1407,59.41,40.58,2
26361,BC,BACĂU,PRĂJEȘTI,874,394,480,45.08,54.91,1
24766,BC,BACĂU,RĂCĂCIUNI,3086,1233,1853,39.95,60.04,1
24837,BC,BACĂU,RĂCHITOASA,2132,1661,471,77.90,22.09,2
24711,BC,BACĂU,RACOVA,1658,1078,580,65.01,34.98,2
24999,BC,BACĂU,ROȘIORI,1138,805,333,70.73,29.26,2
25148,BC,BACĂU,SĂNDULENI,1966,1440,526,73.24,26.75,2
26320,BC,BACĂU,SĂRATA,1089,620,469,56.93,43.06,2
25068,BC,BACĂU,SASCUT,4995,2321,2674,46.46,53.53,1
25228,BC,BACĂU,SĂUCEȘTI,2824,1570,1254,55.59,44.40,2
25291,BC,BACĂU,SCORȚENI,1230,697,533,56.66,43.33,2
25362,BC,BACĂU,SECUIENI,1104,647,457,58.60,41.39,2
20910,BC,BACĂU,SLĂNIC-MOLDOVA,2498,1149,1349,45.99,54.00,1
25488,BC,BACĂU,SOLONȚ,1620,1234,386,76.17,23.82,2
25521,BC,BACĂU,STĂNIȘEȘTI,1849,1404,445,75.93,24.06,2
20670,BC,BACĂU,ȘTEFAN CEL MARE,2640,1868,772,70.75,29.24,2
25629,BC,BACĂU,STRUGARI,1219,884,335,72.51,27.48,2
25692,BC,BACĂU,TAMAȘI,1657,1192,465,71.93,28.06,2
20965,BC,BACĂU,TÂRGU OCNA,6690,3311,3379,49.49,50.50,1
25825,BC,BACĂU,TÂRGU TROTUȘ,2606,1570,1036,60.24,39.75,2
25745,BC,BACĂU,TĂTĂRĂȘTI,1156,842,314,72.83,27.16,2
25861,BC,BACĂU,TRAIAN,1231,421,810,34.19,65.80,1
25932,BC,BACĂU,UNGURENI,1658,1192,466,71.89,28.10,2
26029,BC,BACĂU,URECHEȘTI,1880,925,955,49.20,50.79,1
26083,BC,BACĂU,VALEA SEACĂ,1649,1304,345,79.07,20.92,2
26118,BC,BACĂU,VULTURENI,978,522,456,53.37,46.62,2
26289,BC,BACĂU,ZEMEȘ,2352,1298,1054,55.18,44.81,2
27070,BH,BIHOR,ABRAM,1620,638,982,39.38,60.61,1
27169,BH,BIHOR,ABRĂMUȚ,1276,273,1003,21.39,78.60,1
26699,BH,BIHOR,ALEȘD,5577,1365,4212,24.47,75.52,1
26742,BH,BIHOR,AȘTILEU,2109,744,1365,35.27,64.72,1
27212,BH,BIHOR,AUȘEU,1619,560,1059,34.58,65.41,1
27285,BH,BIHOR,AVRAM IANCU,1706,1022,684,59.90,40.09,2
27329,BH,BIHOR,BALC,1510,636,874,42.11,57.88,1
27383,BH,BIHOR,BATĂR,1899,1051,848,55.34,44.65,2
26804,BH,BIHOR,BEIUȘ,6497,2666,3831,41.03,58.96,1
27436,BH,BIHOR,BIHARIA,1952,254,1698,13.01,86.98,1
27506,BH,BIHOR,BOIANU MARE,643,275,368,42.76,57.23,1
27560,BH,BIHOR,BOROD,2400,1158,1242,48.25,51.75,1
27631,BH,BIHOR,BORȘ,2186,275,1911,12.58,87.41,1
27686,BH,BIHOR,BRATCA,2814,1093,1721,38.84,61.15,1
27757,BH,BIHOR,BRUSTURI,1926,919,1007,47.71,52.28,1
27846,BH,BIHOR,BUDUREASA,1661,614,1047,36.96,63.03,1
27908,BH,BIHOR,BUDUSLĂU,593,179,414,30.18,69.81,1
27935,BH,BIHOR,BULZ,1509,557,952,36.91,63.08,1
27971,BH,BIHOR,BUNTEȘTI,3031,1102,1929,36.35,63.64,1
28077,BH,BIHOR,CĂBEȘTI,1022,475,547,46.47,53.52,1
28709,BH,BIHOR,CÂMPANI,1143,663,480,58.00,41.99,2
28139,BH,BIHOR,CĂPÂLNA,1616,670,946,41.46,58.53,1
28193,BH,BIHOR,CĂRPINET,1296,615,681,47.45,52.54,1
28246,BH,BIHOR,CEFA,1399,632,767,45.17,54.82,1
28335,BH,BIHOR,CEICA,1897,848,1049,44.70,55.29,1
28415,BH,BIHOR,CETARIU,878,195,683,22.20,77.79,1
28497,BH,BIHOR,CHERECHIU,746,164,582,21.98,78.01,1
28530,BH,BIHOR,CHIȘLAZ,1408,508,900,36.07,63.92,1
28610,BH,BIHOR,CIUHOI,1043,283,760,27.13,72.86,1
28665,BH,BIHOR,CIUMEGHIU,1760,938,822,53.29,46.70,2
28763,BH,BIHOR,COCIUBA MARE,1719,653,1066,37.98,62.01,1
28816,BH,BIHOR,COPĂCEL,1471,719,752,48.87,51.12,1
28889,BH,BIHOR,CRIȘTIORU DE JOS,883,561,322,63.53,36.46,2
28941,BH,BIHOR,CURĂȚELE,1542,603,939,39.10,60.89,1
29001,BH,BIHOR,CURTUIȘENI,1406,594,812,42.24,57.75,1
29038,BH,BIHOR,DERNA,1153,580,573,50.30,49.69,2
29092,BH,BIHOR,DIOSIG,2563,997,1566,38.89,61.10,1
29154,BH,BIHOR,DOBREȘTI,2534,1198,1336,47.27,52.72,1
29243,BH,BIHOR,DRĂGĂNEȘTI,1764,921,843,52.21,47.78,2
29341,BH,BIHOR,DRĂGEȘTI,1356,579,777,42.69,57.30,1
29403,BH,BIHOR,FINIȘ,1753,750,1003,42.78,57.21,1
32195,BH,BIHOR,GEPIU,1232,675,557,54.78,45.21,2
29467,BH,BIHOR,GIRIȘU DE CRIȘ,1788,593,1195,33.16,66.83,1
29519,BH,BIHOR,HIDIȘELU DE SUS,2113,859,1254,40.65,59.34,1
29573,BH,BIHOR,HOLOD,1958,1268,690,64.75,35.24,2
29662,BH,BIHOR,HUSASĂU DE TINCA,1177,709,468,60.23,39.76,2
29724,BH,BIHOR,INEU,1971,1039,932,52.71,47.28,2
29813,BH,BIHOR,LĂZĂRENI,1769,1118,651,63.19,36.80,2
29760,BH,BIHOR,LAZURI DE BEIUȘ,1111,297,814,26.73,73.26,1
29902,BH,BIHOR,LUGAȘU DE JOS,2009,1111,898,55.30,44.69,2
29948,BH,BIHOR,LUNCA,2072,816,1256,39.38,60.61,1
30014,BH,BIHOR,MĂDĂRAS,1494,662,832,44.31,55.68,1
30069,BH,BIHOR,MĂGEȘTI,1585,566,1019,35.70,64.29,1
26877,BH,BIHOR,MARGHITA,7889,2531,5358,32.08,67.91,1
30149,BH,BIHOR,NOJORID,3156,977,2179,30.95,69.04,1
26920,BH,BIHOR,NUCET,1278,575,703,44.99,55.00,1
30229,BH,BIHOR,OLCEA,1395,553,842,39.64,60.35,1
26564,BH,BIHOR,ORADEA,114137,35929,78208,31.47,68.52,1
30274,BH,BIHOR,OȘORHEI,3438,964,2474,28.03,71.96,1
32161,BH,BIHOR,PALEU,1345,206,1139,15.31,84.68,1
30336,BH,BIHOR,PIETROASA,1790,958,832,53.51,46.48,2
30416,BH,BIHOR,POCOLA,1088,650,438,59.74,40.25,2
30470,BH,BIHOR,POMEZEU,1628,742,886,45.57,54.42,1
30568,BH,BIHOR,POPEȘTI,3773,2184,1589,57.88,42.11,2
30648,BH,BIHOR,RĂBĂGANI,1253,655,598,52.27,47.72,2
30719,BH,BIHOR,REMETEA,1949,1172,777,60.13,39.86,2
30773,BH,BIHOR,RIENI,2051,770,1281,37.54,62.45,1
30844,BH,BIHOR,ROȘIA,1514,744,770,49.14,50.85,1
32187,BH,BIHOR,ROȘIORI,1208,387,821,32.03,67.96,1
30871,BH,BIHOR,SĂCĂDAT,1074,526,548,48.97,51.02,1
30915,BH,BIHOR,SĂCUENI,4102,1284,2818,31.30,68.69,1
30988,BH,BIHOR,SĂLACEA,909,211,698,23.21,76.78,1
31011,BH,BIHOR,SĂLARD,1569,394,1175,25.11,74.88,1
26975,BH,BIHOR,SALONTA,8190,2483,5707,30.31,69.68,1
31057,BH,BIHOR,SÂMBĂTA,1096,618,478,56.38,43.61,2
26582,BH,BIHOR,SÂNMARTIN,7462,2460,5002,32.96,67.03,1
32179,BH,BIHOR,SÂNNICOLAU ROMÂN,1147,664,483,57.89,42.10,2
26653,BH,BIHOR,SÂNTANDREI,3041,910,2131,29.92,70.07,1
31128,BH,BIHOR,SÂRBI,1506,751,755,49.86,50.13,1
31333,BH,BIHOR,ȘIMIAN,1367,525,842,38.40,61.59,1
31379,BH,BIHOR,ȘINTEU,393,97,296,24.68,75.31,1
31422,BH,BIHOR,ȘOIMI,1356,684,672,50.44,49.55,2
31208,BH,BIHOR,SPINUȘ,653,357,296,54.67,45.32,2
26840,BH,BIHOR,ȘTEI,3849,1807,2042,46.94,53.05,1
31510,BH,BIHOR,ȘUNCUIUȘ,1943,676,1267,34.79,65.20,1
31262,BH,BIHOR,SUPLACU DE BARCĂU,2245,598,1647,26.63,73.36,1
32153,BH,BIHOR,TĂMĂȘEU,983,244,739,24.82,75.17,1
31609,BH,BIHOR,TĂRCAIA,1191,457,734,38.37,61.62,1
31565,BH,BIHOR,TARCEA,841,271,570,32.22,67.77,1
31654,BH,BIHOR,TĂUTEU,1798,743,1055,41.32,58.67,1
31878,BH,BIHOR,ȚEȚCHEA,1624,860,764,52.95,47.04,2
31716,BH,BIHOR,TILEAGD,3329,1004,2325,30.15,69.84,1
31789,BH,BIHOR,TINCA,3724,1419,2305,38.10,61.89,1
32201,BH,BIHOR,TOBOLIU,1072,419,653,39.08,60.91,1
31841,BH,BIHOR,TULCA,1556,624,932,40.10,59.89,1
31921,BH,BIHOR,UILEACU DE BEIUȘ,1467,926,541,63.12,36.87,2
31976,BH,BIHOR,VADU CRIȘULUI,2007,665,1342,33.13,66.86,1
32027,BH,BIHOR,VALEA LUI MIHAI,3516,942,2574,26.79,73.20,1
32090,BH,BIHOR,VÂRCIOROG,1215,356,859,29.30,70.69,1
27007,BH,BIHOR,VAȘCĂU,1603,732,871,45.66,54.33,1
32045,BH,BIHOR,VIIȘOARA,638,180,458,28.21,71.78,1
32483,BN,BISTRIȚA-NĂSĂUD,BECLEAN,6413,3053,3360,47.60,52.39,1
32394,BN,BISTRIȚA-NĂSĂUD,BISTRIȚA,46897,14495,32402,30.90,69.09,1
32633,BN,BISTRIȚA-NĂSĂUD,BISTRIȚA BÂRGĂULUI,2351,683,1668,29.05,70.94,1
32660,BN,BISTRIȚA-NĂSĂUD,BRANIȘTEA,1636,523,1113,31.96,68.03,1
32704,BN,BISTRIȚA-NĂSĂUD,BUDACU DE JOS,1719,877,842,51.01,48.98,2
32768,BN,BISTRIȚA-NĂSĂUD,BUDEȘTI,1026,473,553,46.10,53.89,1
32811,BN,BISTRIȚA-NĂSĂUD,CĂIANU MIC,1956,1280,676,65.43,34.56,2
32884,BN,BISTRIȚA-NĂSĂUD,CETATE,1546,919,627,59.44,40.55,2
33015,BN,BISTRIȚA-NĂSĂUD,CHIOCHIȘ,1704,585,1119,34.33,65.66,1
33122,BN,BISTRIȚA-NĂSĂUD,CHIUZA,1244,650,594,52.25,47.74,2
32955,BN,BISTRIȚA-NĂSĂUD,CICEU-GIURGEȘTI,926,431,495,46.54,53.45,1
179953,BN,BISTRIȚA-NĂSĂUD,CICEU-MIHĂIEȘTI,690,320,370,46.37,53.62,1
33177,BN,BISTRIȚA-NĂSĂUD,COȘBUC,959,532,427,55.47,44.52,2
33202,BN,BISTRIȚA-NĂSĂUD,DUMITRA,2108,634,1474,30.07,69.92,1
179686,BN,BISTRIȚA-NĂSĂUD,DUMITRIȚA,1412,368,1044,26.06,73.93,1
33248,BN,BISTRIȚA-NĂSĂUD,FELDRU,3161,818,2343,25.87,74.12,1
33275,BN,BISTRIȚA-NĂSĂUD,GALAȚII BISTRIȚEI,1458,865,593,59.32,40.67,2
33337,BN,BISTRIȚA-NĂSĂUD,ILVA MARE,1283,367,916,28.60,71.39,1
33364,BN,BISTRIȚA-NĂSĂUD,ILVA MICA,1585,621,964,39.17,60.82,1
33382,BN,BISTRIȚA-NĂSĂUD,JOSENII BÂRGĂULUI,2509,842,1667,33.55,66.44,1
33435,BN,BISTRIȚA-NĂSĂUD,LECHINȚA,3239,1988,1251,61.37,38.62,2
33514,BN,BISTRIȚA-NĂSĂUD,LEȘU,1324,550,774,41.54,58.45,1
33541,BN,BISTRIȚA-NĂSĂUD,LIVEZILE,2232,676,1556,30.28,69.71,1
33603,BN,BISTRIȚA-NĂSĂUD,LUNCA ILVEI,1552,560,992,36.08,63.91,1
33729,BN,BISTRIȚA-NĂSĂUD,MĂGURA ILVEI,1028,400,628,38.91,61.08,1
33621,BN,BISTRIȚA-NĂSĂUD,MAIERU,3869,1176,2693,30.39,69.60,1
33765,BN,BISTRIȚA-NĂSĂUD,MĂRIȘELU,1315,580,735,44.10,55.89,1
33658,BN,BISTRIȚA-NĂSĂUD,MATEI,1627,611,1016,37.55,62.44,1
33845,BN,BISTRIȚA-NĂSĂUD,MICEȘTII DE CÂMPIE,609,231,378,37.93,62.06,1
33881,BN,BISTRIȚA-NĂSĂUD,MILAȘ,869,572,297,65.82,34.17,2
33952,BN,BISTRIȚA-NĂSĂUD,MONOR,882,472,410,53.51,46.48,2
32544,BN,BISTRIȚA-NĂSĂUD,NĂSĂUD,5687,2198,3489,38.64,61.35,1
179659,BN,BISTRIȚA-NĂSĂUD,NEGRILEȘTI,1333,730,603,54.76,45.23,2
33989,BN,BISTRIȚA-NĂSĂUD,NIMIGEA,2757,1206,1551,43.74,56.25,1
34075,BN,BISTRIȚA-NĂSĂUD,NUȘENI,1951,537,1414,27.52,72.47,1
34155,BN,BISTRIȚA-NĂSĂUD,PARVA,948,403,545,42.51,57.48,1
34173,BN,BISTRIȚA-NĂSĂUD,PETRU RAREȘ,1694,802,892,47.34,52.65,1
179720,BN,BISTRIȚA-NĂSĂUD,POIANA ILVEI,874,378,496,43.24,56.75,1
34235,BN,BISTRIȚA-NĂSĂUD,PRUNDU BÂRGĂULUI,3500,1079,2421,30.82,69.17,1
34262,BN,BISTRIȚA-NĂSĂUD,REBRA,914,225,689,24.61,75.38,1
34280,BN,BISTRIȚA-NĂSĂUD,REBRIȘOARA,2026,604,1422,29.81,70.18,1
34333,BN,BISTRIȚA-NĂSĂUD,RODNA,3165,1466,1699,46.31,53.68,1
34360,BN,BISTRIȚA-NĂSĂUD,ROMULI,992,615,377,61.99,38.00,2
179944,BN,BISTRIȚA-NĂSĂUD,RUNCU SALVEI,748,146,602,19.51,80.48,1
34397,BN,BISTRIȚA-NĂSĂUD,SALVA,1525,846,679,55.47,44.52,2
32599,BN,BISTRIȚA-NĂSĂUD,SÂNGEORZ-BĂI,566,304,262,53.71,46.28,2
34477,BN,BISTRIȚA-NĂSĂUD,SÂNMIHAIU DE CÂMPIE,4897,1399,3498,28.56,71.43,1
34618,BN,BISTRIȚA-NĂSĂUD,ȘANȚ,1971,1235,736,62.65,37.34,2
34645,BN,BISTRIȚA-NĂSĂUD,ȘIEU,1504,629,875,41.82,58.17,1
34690,BN,BISTRIȚA-NĂSĂUD,ȘIEU-MĂGHERUȘ,2055,652,1403,31.72,68.27,1
34770,BN,BISTRIȚA-NĂSĂUD,ȘIEU-ODORHEI,1525,718,807,47.08,52.91,1
34850,BN,BISTRIȚA-NĂSĂUD,ȘIEUȚ,1483,723,760,48.75,51.24,1
34422,BN,BISTRIȚA-NĂSĂUD,SILIVAȘU DE CÂMPIE,922,568,354,61.60,38.39,2
34903,BN,BISTRIȚA-NĂSĂUD,ȘINTEREAG,2364,1113,1251,47.08,52.91,1
34547,BN,BISTRIȚA-NĂSĂUD,SPERMEZEU,1811,382,1429,21.09,78.90,1
35152,BN,BISTRIȚA-NĂSĂUD,TÂRLIȘUA,3181,474,2707,14.90,85.09,1
34985,BN,BISTRIȚA-NĂSĂUD,TEACA,2737,1311,1426,47.89,52.10,1
35054,BN,BISTRIȚA-NĂSĂUD,TELCIU,2723,669,2054,24.56,75.43,1
35090,BN,BISTRIȚA-NĂSĂUD,TIHA BÂRGĂULUI,1800,873,927,48.50,51.50,1
35269,BN,BISTRIȚA-NĂSĂUD,URIU,2167,904,1263,41.71,58.28,1
35312,BN,BISTRIȚA-NĂSĂUD,URMENIȘ,974,437,537,44.86,55.13,1
35429,BN,BISTRIȚA-NĂSĂUD,ZAGRA,1863,1021,842,54.80,45.19,2
40035,BT,BOTOȘANI,ADĂȘENI,597,382,215,63.98,36.01,2
36131,BT,BOTOȘANI,ALBEȘTI,2568,1535,1033,59.77,40.22,2
36202,BT,BOTOȘANI,AVRĂMENI,1650,1237,413,74.96,25.03,2
36300,BT,BOTOȘANI,BĂLUȘENI,2281,1631,650,71.50,28.49,2
39983,BT,BOTOȘANI,BLÂNDEȘTI,986,698,288,70.79,29.20,2
35731,BT,BOTOȘANI,BOTOȘANI,56639,32201,24438,56.85,43.14,2
36373,BT,BOTOȘANI,BRĂEȘTI,1024,646,378,63.08,36.91,2
36426,BT,BOTOȘANI,BROSCĂUȚI,1586,1175,411,74.08,25.91,2
36453,BT,BOTOȘANI,BUCECEA,2275,1503,772,66.06,33.93,2
36499,BT,BOTOȘANI,CĂLĂRAȘI,1782,830,952,46.57,53.42,1
39967,BT,BOTOȘANI,CÂNDEȘTI,1016,642,374,63.18,36.81,2
36532,BT,BOTOȘANI,CONCEȘTI,982,790,192,80.44,19.55,2
36569,BT,BOTOȘANI,COPĂLĂU,1998,1118,880,55.95,44.04,2
36649,BT,BOTOȘANI,CORDĂRENI,956,606,350,63.38,36.61,2
36676,BT,BOTOȘANI,CORLĂTENI,1076,691,385,64.21,35.78,2
36756,BT,BOTOȘANI,CORNI,2655,1902,753,71.63,28.36,2
39975,BT,BOTOȘANI,COȘULA,1274,917,357,71.97,28.02,2
36809,BT,BOTOȘANI,COȚUȘCA,2251,1405,846,62.41,37.58,2
36907,BT,BOTOȘANI,CRISTEȘTI,1861,1251,610,67.22,32.77,2
36952,BT,BOTOȘANI,CRISTINEȘTI,1869,1149,720,61.47,38.52,2
35759,BT,BOTOȘANI,CURTEȘTI,2215,1409,806,63.61,36.38,2
37057,BT,BOTOȘANI,DÂNGENI,1561,783,778,50.16,49.83,2
35946,BT,BOTOȘANI,DARABANI,5187,3335,1852,64.29,35.70,2
37011,BT,BOTOȘANI,DERSCA,1355,837,518,61.77,38.22,2
39959,BT,BOTOȘANI,DIMĂCHENI,749,640,109,85.44,14.55,2
37100,BT,BOTOȘANI,DOBÂRCENI,1320,651,669,49.31,50.68,1
36006,BT,BOTOȘANI,DOROHOI,13660,9249,4411,67.70,32.29,2
37173,BT,BOTOȘANI,DRĂGUȘENI,1171,897,274,76.60,23.39,2
37217,BT,BOTOȘANI,DURNEȘTI,1840,906,934,49.23,50.76,1
37280,BT,BOTOȘANI,FLĂMÂNZI,4861,2473,2388,50.87,49.12,2
37324,BT,BOTOȘANI,FRUMUȘICA,2336,1680,656,71.91,28.08,2
37397,BT,BOTOȘANI,GEORGE ENESCU,1702,942,760,55.34,44.65,2
37459,BT,BOTOȘANI,GORBĂNEȘTI,1660,1147,513,69.09,30.90,2
37618,BT,BOTOȘANI,HĂNEȘTI,950,588,362,61.89,38.10,2
37547,BT,BOTOȘANI,HAVÂRNA,1911,1280,631,66.98,33.01,2
37672,BT,BOTOȘANI,HILIȘEU-HORIA,1657,1340,317,80.86,19.13,2
37734,BT,BOTOȘANI,HLIPICENI,1602,977,625,60.98,39.01,2
37770,BT,BOTOȘANI,HUDEȘTI,3177,2243,934,70.60,29.39,2
37823,BT,BOTOȘANI,IBĂNEȘTI,1875,1224,651,65.28,34.72,2
37850,BT,BOTOȘANI,LEORDA,1485,823,662,55.42,44.57,2
39942,BT,BOTOȘANI,LOZNA,990,743,247,75.05,24.94,2
37912,BT,BOTOȘANI,LUNCA,1964,1340,624,68.22,31.77,2
37958,BT,BOTOȘANI,MANOLEASA,1548,1002,546,64.72,35.27,2
38063,BT,BOTOȘANI,MIHAI EMINESCU,3664,1986,1678,54.20,45.79,2
38161,BT,BOTOȘANI,MIHĂILENI,1252,787,465,62.85,37.14,2
38241,BT,BOTOȘANI,MIHĂLĂȘENI,1085,498,587,45.89,54.10,1
38321,BT,BOTOȘANI,MILEANCA,1303,843,460,64.69,35.30,2
38376,BT,BOTOȘANI,MITOC,725,592,133,81.65,18.34,2
38456,BT,BOTOȘANI,NICȘENI,1200,780,420,65.00,35.00,2
38492,BT,BOTOȘANI,PĂLTINIȘ,1673,802,871,47.93,52.06,1
38544,BT,BOTOȘANI,POMÂRLA,1392,1097,295,78.80,21.19,2
38580,BT,BOTOȘANI,PRĂJENI,1402,868,534,61.91,38.08,2
35839,BT,BOTOȘANI,RĂCHIȚI,2345,1504,841,64.13,35.86,2
38633,BT,BOTOȘANI,RĂDĂUȚI-PRUT,1695,1033,662,60.94,39.05,2
38679,BT,BOTOȘANI,RĂUSENI,1139,823,316,72.25,27.74,2
38731,BT,BOTOȘANI,RIPICENI,994,559,435,56.23,43.76,2
38811,BT,BOTOȘANI,ROMA,1710,1174,536,68.65,31.34,2
38848,BT,BOTOȘANI,ROMÂNEȘTI,1041,814,227,78.19,21.80,2
38893,BT,BOTOȘANI,SANTA MARE,1338,597,741,44.61,55.38,1
36060,BT,BOTOȘANI,SĂVENI,3720,2796,924,75.16,24.83,2
39122,BT,BOTOȘANI,ȘENDRICENI,1780,1130,650,63.48,36.51,2
35884,BT,BOTOȘANI,STĂUCENI,1577,1007,570,63.85,36.14,2
39168,BT,BOTOȘANI,ȘTEFĂNEȘTI,2599,1640,959,63.10,36.89,2
39220,BT,BOTOȘANI,ȘTIUBIENI,1229,757,472,61.59,38.40,2
38982,BT,BOTOȘANI,SUHARĂU,2409,1610,799,66.83,33.16,2
39051,BT,BOTOȘANI,SULIȚA,1494,1051,443,70.34,29.65,2
39266,BT,BOTOȘANI,TODIRENI,1576,1136,440,72.08,27.91,2
39328,BT,BOTOȘANI,TRUȘEȘTI,2583,1604,979,62.09,37.90,2
39391,BT,BOTOȘANI,TUDORA,2122,1526,596,71.91,28.08,2
39417,BT,BOTOȘANI,UNGURENI,2652,1589,1063,59.91,40.08,2
39532,BT,BOTOȘANI,UNȚENI,1302,881,421,67.66,32.33,2
39612,BT,BOTOȘANI,VĂCULEȘTI,1124,811,313,72.15,27.84,2
39694,BT,BOTOȘANI,VÂRFU CÂMPULUI,1983,1169,814,58.95,41.04,2
39658,BT,BOTOȘANI,VIIȘOARA,975,665,310,68.20,31.79,2
39738,BT,BOTOȘANI,VLĂDENI,2045,1471,574,71.93,28.06,2
39792,BT,BOTOȘANI,VLĂSINEȘTI,1744,1400,344,80.27,19.72,2
39836,BT,BOTOȘANI,VORNICENI,1677,1002,675,59.74,40.25,2
39872,BT,BOTOȘANI,VORONA,3290,2362,928,71.79,28.20,2
42824,BR,BRĂILA,BĂRĂGANUL,1375,943,432,68.58,31.41,2
42842,BR,BRĂILA,BERTEȘTII DE JOS,1334,760,574,56.97,43.02,2
42913,BR,BRĂILA,BORDEI VERDE,1486,854,632,57.46,42.53,2
42682,BR,BRĂILA,BRĂILA,106332,58314,48018,54.84,45.15,2
44560,BR,BRĂILA,CAZASU,1634,762,872,46.63,53.36,1
42708,BR,BRĂILA,CHIȘCANI,2486,1388,1098,55.83,44.16,2
42968,BR,BRĂILA,CIOCILE,1291,935,356,72.42,27.57,2
43019,BR,BRĂILA,CIREȘU,1573,758,815,48.18,51.81,1
43073,BR,BRĂILA,DUDEȘTI,1661,1249,412,75.19,24.80,2
42753,BR,BRĂILA,FĂUREI,2063,1199,864,58.11,41.88,2
43117,BR,BRĂILA,FRECĂȚEI,724,317,407,43.78,56.21,1
43180,BR,BRĂILA,GALBENU,1434,1120,314,78.10,21.89,2
43242,BR,BRĂILA,GEMENELE,988,708,280,71.65,28.34,2
43279,BR,BRĂILA,GRADIȘTEA,1176,494,682,42.00,57.99,1
43313,BR,BRĂILA,GROPENI,1636,1003,633,61.30,38.69,2
43331,BR,BRĂILA,IANCA,5415,3528,1887,65.15,34.84,2
43411,BR,BRĂILA,ÎNSURĂȚEI,2861,1949,912,68.12,31.87,2
43466,BR,BRĂILA,JIRLĂU,1211,802,409,66.22,33.77,2
43493,BR,BRĂILA,MĂRAȘU,1358,691,667,50.88,49.11,2
43563,BR,BRĂILA,MĂXINENI,1600,907,693,56.68,43.31,2
43625,BR,BRĂILA,MIRCEA VODĂ,1531,898,633,58.65,41.34,2
43652,BR,BRĂILA,MOVILA MIRESII,2108,1657,451,78.60,21.39,2
43698,BR,BRĂILA,RACOVIȚĂ,590,445,145,75.42,24.57,2
43732,BR,BRĂILA,RÂMNICELU,929,678,251,72.98,27.01,2
43787,BR,BRĂILA,ROMANU,864,525,339,60.76,39.23,2
43812,BR,BRĂILA,ROȘIORI,1292,1062,230,82.19,17.80,2
43867,BR,BRĂILA,SALCIA TUDOR,1294,638,656,49.30,50.69,1
43929,BR,BRĂILA,SCORȚARU NOU,702,353,349,50.28,49.71,2
43992,BR,BRĂILA,SILIȘTEA,1037,709,328,68.37,31.62,2
44060,BR,BRĂILA,STĂNCUȚA,1778,1274,504,71.65,28.34,2
44113,BR,BRĂILA,SURDILA-GĂISEANCA,1320,896,424,67.87,32.12,2
42771,BR,BRĂILA,SURDILA-GRECI,896,415,481,46.31,53.68,1
44140,BR,BRĂILA,ȘUȚEȘTI,1940,1164,776,60.00,40.00,2
44177,BR,BRĂILA,TICHILEȘTI,1924,1001,923,52.02,47.97,2
44202,BR,BRĂILA,TRAIAN,1546,1064,482,68.82,31.17,2
44257,BR,BRĂILA,TUDOR VLADIMIRESCU,1187,798,389,67.22,32.77,2
44300,BR,BRĂILA,TUFEȘTI,2592,1796,796,69.29,30.70,2
44328,BR,BRĂILA,ULMU,1904,1290,614,67.75,32.24,2
44355,BR,BRĂILA,UNIREA,1292,700,592,54.17,45.82,2
44391,BR,BRĂILA,VĂDENI,1951,1188,763,60.89,39.10,2
44435,BR,BRĂILA,VICTORIA,1803,1042,761,57.79,42.20,2
44462,BR,BRĂILA,VIȘANI,1361,1061,300,77.95,22.04,2
44505,BR,BRĂILA,VIZIRU,2811,1802,1009,64.10,35.89,2
44532,BR,BRĂILA,ZĂVOAIA,1724,855,869,49.59,50.40,1
40526,BV,BRAȘOV,APAȚA,1238,251,987,20.27,79.72,1
42498,BV,BRAȘOV,AUGUSTIN,728,322,406,44.23,55.76,1
40544,BV,BRAȘOV,BECLEAN,975,414,561,42.46,57.53,1
40606,BV,BRAȘOV,BOD,2433,867,1566,35.63,64.36,1
40633,BV,BRAȘOV,BRAN,3902,1220,2682,31.26,68.73,1
40198,BV,BRAȘOV,BRAȘOV,160451,58866,101585,36.68,63.31,1
40688,BV,BRAȘOV,BUDILA,1912,622,1290,32.53,67.46,1
40704,BV,BRAȘOV,BUNEȘTI,1256,504,752,40.12,59.87,1
40768,BV,BRAȘOV,CAȚA,1297,400,897,30.84,69.15,1
40820,BV,BRAȘOV,CINCU,1140,365,775,32.01,67.98,1
40241,BV,BRAȘOV,CODLEA,12564,5402,7162,42.99,57.00,1
40857,BV,BRAȘOV,COMANA,1327,422,905,31.80,68.19,1
40900,BV,BRAȘOV,CRISTIAN,2984,1070,1914,35.85,64.14,1
42456,BV,BRAȘOV,CRIZBAV,1288,750,538,58.22,41.77,2
42480,BV,BRAȘOV,DRĂGUȘ,800,82,718,10.25,89.75,1
40928,BV,BRAȘOV,DUMBRĂVIȚA,2521,705,1816,27.96,72.03,1
40278,BV,BRAȘOV,FĂGĂRAȘ,16671,6220,10451,37.31,62.68,1
40955,BV,BRAȘOV,FELDIOARA,3689,1297,2392,35.15,64.84,1
40991,BV,BRAȘOV,FUNDATA,592,179,413,30.23,69.76,1
40214,BV,BRAȘOV,GHIMBAV,3111,1163,1948,37.38,62.61,1
41033,BV,BRAȘOV,HĂLCHIU,2431,867,1564,35.66,64.33,1
41088,BV,BRAȘOV,HĂRMAN,3206,1104,2102,34.43,65.56,1
41113,BV,BRAȘOV,HÂRSENI,1370,525,845,38.32,61.67,1
41177,BV,BRAȘOV,HOGHIZ,2470,988,1482,40.00,60.00,1
42472,BV,BRAȘOV,HOLBAV,648,289,359,44.59,55.40,1
41248,BV,BRAȘOV,HOMOROD,1131,314,817,27.76,72.23,1
41284,BV,BRAȘOV,JIBERT,1160,352,808,30.34,69.65,1
41346,BV,BRAȘOV,LISA,1101,291,810,26.43,73.56,1
41382,BV,BRAȘOV,MĂIERUȘ,1496,390,1106,26.06,73.93,1
41417,BV,BRAȘOV,MÂNDRA,1807,835,972,46.20,53.79,1
41471,BV,BRAȘOV,MOIECIU,3428,1296,2132,37.80,62.19,1
41541,BV,BRAȘOV,ORMENIȘ,1024,433,591,42.28,57.71,1
41578,BV,BRAȘOV,PĂRĂU,1141,447,694,39.17,60.82,1
41621,BV,BRAȘOV,POIANA MĂRULUI,1645,454,1191,27.59,72.40,1
40303,BV,BRAȘOV,PREDEAL,3866,1343,2523,34.73,65.26,1
41667,BV,BRAȘOV,PREJMER,4805,1774,3031,36.91,63.08,1
41701,BV,BRAȘOV,RACOȘ,1300,529,771,40.69,59.30,1
40367,BV,BRAȘOV,RÂȘNOV,9196,3772,5424,41.01,58.98,1
41738,BV,BRAȘOV,RECEA,1715,502,1213,29.27,70.72,1
40394,BV,BRAȘOV,RUPEA,2730,1037,1693,37.98,62.01,1
40438,BV,BRAȘOV,SĂCELE,16498,6009,10489,36.42,63.57,1
42464,BV,BRAȘOV,SÂMBĂTA DE SUS,1151,428,723,37.18,62.81,1
41925,BV,BRAȘOV,SÂNPETRU,3080,989,2091,32.11,67.88,1
41818,BV,BRAȘOV,ȘERCAIA,1299,265,1034,20.40,79.59,1
41854,BV,BRAȘOV,ȘINCA,1923,596,1327,30.99,69.00,1
42449,BV,BRAȘOV,ȘINCA NOUĂ,1142,216,926,18.91,81.08,1
41943,BV,BRAȘOV,ȘOARȘ,1023,254,769,24.82,75.17,1
42003,BV,BRAȘOV,TĂRLUNGENI,4304,1712,2592,39.77,60.22,1
42058,BV,BRAȘOV,TELIU,2127,978,1149,45.98,54.01,1
42076,BV,BRAȘOV,TICUȘU,504,218,286,43.25,56.74,1
42101,BV,BRAȘOV,UCEA,1255,248,1007,19.76,80.23,1
42156,BV,BRAȘOV,UNGRA,985,597,388,60.60,39.39,2
42183,BV,BRAȘOV,VAMA BUZĂULUI,1555,682,873,43.85,56.14,1
40465,BV,BRAȘOV,VICTORIA,3722,1042,2680,27.99,72.00,1
42236,BV,BRAȘOV,VIȘTEA,1195,272,923,22.76,77.23,1
42307,BV,BRAȘOV,VOILA,1813,745,1068,41.09,58.90,1
42398,BV,BRAȘOV,VULCAN,2437,931,1506,38.20,61.79,1
40492,BV,BRAȘOV,ZĂRNEȘTI,13689,6297,7392,46.00,53.99,1
179141,B,BUCUREȘTI,BUCUREȘTI SECTORUL 1,147939,57658,90281,38.97,61.02,1
179150,B,BUCUREȘTI,BUCUREȘTI SECTORUL 2,208624,88722,119902,42.52,57.47,1
179169,B,BUCUREȘTI,BUCUREȘTI SECTORUL 3,236189,99361,136828,42.06,57.93,1
179178,B,BUCUREȘTI,BUCUREȘTI SECTORUL 4,176093,78328,97765,44.48,55.51,1
179187,B,BUCUREȘTI,BUCUREȘTI SECTORUL 5,151524,72120,79404,47.59,52.40,1
179196,B,BUCUREȘTI,BUCUREȘTI SECTORUL 6,225235,92646,132589,41.13,58.86,1
44863,BZ,BUZĂU,AMARU,1267,929,338,73.32,26.67,2
44989,BZ,BUZĂU,BĂLĂCEANU,901,673,228,74.69,25.30,2
44934,BZ,BUZĂU,BALTA ALBĂ,1340,692,648,51.64,48.35,2
45003,BZ,BUZĂU,BECENI,2467,1691,776,68.54,31.45,2
45101,BZ,BUZĂU,BERCA,4853,2367,2486,48.77,51.22,1
45245,BZ,BUZĂU,BISOCA,1111,844,267,75.96,24.03,2
45334,BZ,BUZĂU,BLĂJANI,788,651,137,82.61,17.38,2
45361,BZ,BUZĂU,BOLDU,1408,1064,344,75.56,24.43,2
45389,BZ,BUZĂU,BOZIORU,586,368,218,62.79,37.20,2
45496,BZ,BUZĂU,BRĂDEANU,1423,938,485,65.91,34.08,2
45539,BZ,BUZĂU,BRĂEȘTI,1153,822,331,71.29,28.70,2
45619,BZ,BUZĂU,BREAZA,1332,816,516,61.26,38.73,2
45673,BZ,BUZĂU,BUDA,1516,1007,509,66.42,33.57,2
44818,BZ,BUZĂU,BUZĂU,68605,35596,33009,51.88,48.11,2
45815,BZ,BUZĂU,C.A. ROSETTI,2061,1575,486,76.41,23.58,2
45753,BZ,BUZĂU,CALVINI,1744,1122,622,64.33,35.66,2
45888,BZ,BUZĂU,CĂNEȘTI,506,220,286,43.47,56.52,1
45959,BZ,BUZĂU,CĂTINA,1390,689,701,49.56,50.43,1
46019,BZ,BUZĂU,CERNĂTEȘTI,2046,1230,816,60.11,39.88,2
46108,BZ,BUZĂU,CHILIILE,391,328,63,83.88,16.11,2
46180,BZ,BUZĂU,CHIOJDU,1752,1071,681,61.13,38.86,2
46251,BZ,BUZĂU,CILIBIA,1111,439,672,39.51,60.48,1
46313,BZ,BUZĂU,CISLĂU,2608,1658,950,63.57,36.42,2
46377,BZ,BUZĂU,COCHIRLEANCA,2516,1589,927,63.15,36.84,2
46439,BZ,BUZĂU,COLȚI,676,413,263,61.09,38.90,2
46484,BZ,BUZĂU,COSTEȘTI,2558,1665,893,65.08,34.91,2
46554,BZ,BUZĂU,COZIENI,1122,758,364,67.55,32.44,2
50564,BZ,BUZĂU,FLORICA,808,584,224,72.27,27.72,2
46769,BZ,BUZĂU,GĂLBINAȘI,2297,1429,868,62.21,37.78,2
46803,BZ,BUZĂU,GHERĂSENI,1930,1184,746,61.34,38.65,2
46830,BZ,BUZĂU,GHERGHEASA,1369,1015,354,74.14,25.85,2
46910,BZ,BUZĂU,GLODEANU-SILIȘTEA,2036,1344,692,66.01,33.98,2
46867,BZ,BUZĂU,GLODEANU SĂRAT,2174,1349,825,62.05,37.94,2
47006,BZ,BUZĂU,GREBĂNU,2693,1819,874,67.54,32.45,2
47079,BZ,BUZĂU,GURA TEGHII,2018,982,1036,48.66,51.33,1
47159,BZ,BUZĂU,LARGU,786,628,158,79.89,20.10,2
47186,BZ,BUZĂU,LOPĂTARI,2036,1250,786,61.39,38.60,2
47300,BZ,BUZĂU,LUCIU,1574,1347,227,85.57,14.42,2
47337,BZ,BUZĂU,MĂGURA,1397,954,443,68.28,31.71,2
47630,BZ,BUZĂU,MÂNZĂLEȘTI,1267,766,501,60.45,39.54,2
47373,BZ,BUZĂU,MĂRĂCINENI,4513,2593,1920,57.45,42.54,2
47417,BZ,BUZĂU,MĂRGĂRITEȘTI,445,322,123,72.35,27.64,2
47453,BZ,BUZĂU,MEREI,4035,2544,1491,63.04,36.95,2
47578,BZ,BUZĂU,MIHĂILEȘTI,875,622,253,71.08,28.91,2
47774,BZ,BUZĂU,MOVILA BANULUI,1446,1020,426,70.53,29.46,2
47818,BZ,BUZĂU,MURGEȘTI,612,447,165,73.03,26.96,2
47854,BZ,BUZĂU,NĂENI,915,602,313,65.79,34.20,2
47916,BZ,BUZĂU,NEHOIU,6514,3373,3141,51.78,48.21,2
48021,BZ,BUZĂU,ODĂILE,505,391,114,77.42,22.57,2
48138,BZ,BUZĂU,PADINA,2030,1485,545,73.15,26.84,2
48227,BZ,BUZĂU,PĂNĂTĂU,1396,1080,316,77.36,22.63,2
48165,BZ,BUZĂU,PARDOȘI,272,207,65,76.10,23.89,2
48557,BZ,BUZĂU,PÂRSCOV,2847,1746,1101,61.32,38.67,2
48325,BZ,BUZĂU,PĂTÂRLAGELE,4267,2644,1623,61.96,38.03,2
48487,BZ,BUZĂU,PIETROASELE,1660,971,689,58.49,41.50,2
48682,BZ,BUZĂU,PODGORIA,1640,1102,538,67.19,32.80,2
48744,BZ,BUZĂU,POGOANELE,3998,3075,923,76.91,23.08,2
48771,BZ,BUZĂU,POȘTA CÂLNĂU,3120,1799,1321,57.66,42.33,2
48842,BZ,BUZĂU,PUIEȘTI,1988,1258,730,63.27,36.72,2
48922,BZ,BUZĂU,RACOVIȚENI,696,504,192,72.41,27.58,2
48968,BZ,BUZĂU,RÂMNICELU,2108,1305,803,61.90,38.09,2
44845,BZ,BUZĂU,RÂMNICU SĂRAT,19030,11965,7065,62.87,37.12,2
49019,BZ,BUZĂU,ROBEASCA,634,542,92,85.48,14.51,2
49046,BZ,BUZĂU,RUȘEȚU,2258,1342,916,59.43,40.56,2
49073,BZ,BUZĂU,SĂGEATA,3064,2218,846,72.38,27.61,2
49153,BZ,BUZĂU,SĂHĂTENI,1545,961,584,62.20,37.79,2
49206,BZ,BUZĂU,SĂPOCA,2103,1304,799,62.00,37.99,2
49233,BZ,BUZĂU,SĂRULEȘTI,724,526,198,72.65,27.34,2
49313,BZ,BUZĂU,SCORȚOASA,1405,962,443,68.46,31.53,2
49439,BZ,BUZĂU,SCUTELNICI,1101,795,306,72.20,27.79,2
49484,BZ,BUZĂU,SIRIU,1734,908,826,52.36,47.63,2
49545,BZ,BUZĂU,SMEENI,3404,2397,1007,70.41,29.58,2
49625,BZ,BUZĂU,STÂLPU,1694,1196,498,70.60,29.39,2
49849,BZ,BUZĂU,ȚINTEȘTI,2288,1690,598,73.86,26.13,2
49643,BZ,BUZĂU,TISĂU,2621,1520,1101,57.99,42.00,2
49769,BZ,BUZĂU,TOPLICENI,2292,1307,985,57.02,42.97,2
49894,BZ,BUZĂU,ULMENI,1653,1121,532,67.81,32.18,2
50549,BZ,BUZĂU,UNGURIU,1248,759,489,60.81,39.18,2
49956,BZ,BUZĂU,VADU PAȘII,5086,3275,1811,64.39,35.60,2
50399,BZ,BUZĂU,VÂLCELELE,3027,1950,1077,64.42,35.57,2
50022,BZ,BUZĂU,VALEA RÂMNICULUI,820,539,281,65.73,34.26,2
50068,BZ,BUZĂU,VALEA SALCIEI,385,206,179,53.50,46.49,2
50102,BZ,BUZĂU,VERNEȘTI,4400,2559,1841,58.15,41.84,2
50228,BZ,BUZĂU,VINTILĂ VODĂ,1549,1090,459,70.36,29.63,2
50326,BZ,BUZĂU,VIPEREȘTI,1773,1300,473,73.32,26.67,2
50415,BZ,BUZĂU,ZĂRNEȘTI,3054,2314,740,75.76,24.23,2
50479,BZ,BUZĂU,ZIDURI,2412,1810,602,75.04,24.95,2
94125,CL,CĂLĂRAȘI,ALEXANDRU ODOBESCU,1823,757,1066,41.52,58.47,1
101083,CL,CĂLĂRAȘI,BELCIUGATELE,1511,667,844,44.14,55.85,1
92961,CL,CĂLĂRAȘI,BORCEA,4044,2169,1875,53.63,46.36,2
101458,CL,CĂLĂRAȘI,BUDEȘTI,3468,2190,1278,63.14,36.85,2
92569,CL,CĂLĂRAȘI,CĂLĂRAȘI,35592,18265,17327,51.31,48.68,2
101724,CL,CĂLĂRAȘI,CĂSCIOARELE,976,477,499,48.87,51.12,1
101804,CL,CĂLĂRAȘI,CHIRNOGI,3079,1940,1139,63.00,36.99,2
101822,CL,CĂLĂRAȘI,CHISELET,1464,885,579,60.45,39.54,2
93085,CL,CĂLĂRAȘI,CIOCĂNEȘTI,2404,1218,1186,50.66,49.33,2
180055,CL,CĂLĂRAȘI,CRIVĂȚ,1143,509,634,44.53,55.46,1
102419,CL,CĂLĂRAȘI,CURCANI,2849,1668,1181,58.54,41.45,2
93281,CL,CĂLĂRAȘI,CUZA VODA,2155,1277,878,59.25,40.74,2
93325,CL,CĂLĂRAȘI,DICHISENI,1135,477,658,42.02,57.97,1
93370,CL,CĂLĂRAȘI,DOR MĂRUNT,3269,1100,2169,33.64,66.35,1
93441,CL,CĂLĂRAȘI,DOROBANȚU,1862,843,1019,45.27,54.72,1
93487,CL,CĂLĂRAȘI,DRAGALINA,3629,2220,1409,61.17,38.82,2
93539,CL,CĂLĂRAȘI,DRAGOȘ VODĂ,1534,672,862,43.80,56.19,1
102838,CL,CĂLĂRAȘI,FRĂSINET,945,421,524,44.55,55.44,1
102945,CL,CĂLĂRAȘI,FRUMUȘANI,2592,1433,1159,55.28,44.71,2
103014,CL,CĂLĂRAȘI,FUNDENI,2549,1678,871,65.82,34.17,2
103032,CL,CĂLĂRAȘI,FUNDULEA,4192,2432,1760,58.01,41.98,2
179962,CL,CĂLĂRAȘI,GĂLBINAȘI,1909,1648,261,86.32,13.67,2
93664,CL,CĂLĂRAȘI,GRĂDIȘTEA,3067,1281,1786,41.76,58.23,1
103568,CL,CĂLĂRAȘI,GURBĂNEȘTI,866,393,473,45.38,54.61,1
103764,CL,CĂLĂRAȘI,ILEANA,1523,1142,381,74.98,25.01,2
93771,CL,CĂLĂRAȘI,INDEPENDENȚA,2048,1073,975,52.39,47.60,2
93815,CL,CĂLĂRAȘI,JEGĂLIA,2367,1016,1351,42.92,57.07,1
93851,CL,CĂLĂRAȘI,LEHLIU,1241,664,577,53.50,46.49,2
93888,CL,CĂLĂRAȘI,LEHLIU GARĂ,4098,2286,1812,55.78,44.21,2
104083,CL,CĂLĂRAȘI,LUICA,1017,629,388,61.84,38.15,2
93931,CL,CĂLĂRAȘI,LUPȘANU,1636,1200,436,73.34,26.65,2
104181,CL,CĂLĂRAȘI,MÂNĂSTIREA,2483,1327,1156,53.44,46.55,2
100638,CL,CĂLĂRAȘI,MITRENI,2117,1404,713,66.32,33.67,2
92587,CL,CĂLĂRAȘI,MODELU,4643,1979,2664,42.62,57.37,1
104323,CL,CĂLĂRAȘI,NANA,1084,744,340,68.63,31.36,2
104341,CL,CĂLĂRAȘI,NICOLAE BĂLCESCU,786,405,381,51.52,48.47,2
100610,CL,CĂLĂRAȘI,OLTENIȚA,12995,8989,4006,69.17,30.82,2
94223,CL,CĂLĂRAȘI,PERIȘORU,2324,1411,913,60.71,39.28,2
104635,CL,CĂLĂRAȘI,PLĂTĂREȘTI,2301,1156,1145,50.23,49.76,2
104751,CL,CĂLĂRAȘI,RADOVANU,2423,1325,1098,54.68,45.31,2
94312,CL,CĂLĂRAȘI,ROSEȚI,3033,1548,1485,51.03,48.96,2
104886,CL,CĂLĂRAȘI,SĂRULEȘTI,1693,1223,470,72.23,27.76,2
105222,CL,CĂLĂRAȘI,SOHATU,1264,863,401,68.27,31.72,2
105384,CL,CĂLĂRAȘI,ȘOLDANU,1924,1089,835,56.60,43.39,2
105259,CL,CĂLĂRAȘI,SPANȚOV,2036,1233,803,60.55,39.44,2
94562,CL,CĂLĂRAȘI,ȘTEFAN CEL MARE,1608,1101,507,68.47,31.52,2
94580,CL,CĂLĂRAȘI,ȘTEFAN VODĂ,1360,633,727,46.54,53.45,1
105455,CL,CĂLĂRAȘI,TĂMĂDĂU MARE,1220,604,616,49.50,50.49,1
105605,CL,CĂLĂRAȘI,ULMENI,2425,1402,1023,57.81,42.18,2
94606,CL,CĂLĂRAȘI,ULMU,1136,375,761,33.01,66.98,1
94651,CL,CĂLĂRAȘI,UNIREA,1686,1017,669,60.32,39.67,2
94731,CL,CĂLĂRAȘI,VÂLCELELE,2102,804,1298,38.24,61.75,1
105712,CL,CĂLĂRAȘI,VALEA ARGOVEI,1359,648,711,47.68,52.31,1
105829,CL,CĂLĂRAȘI,VASILAȚI,2502,1622,880,64.82,35.17,2
94768,CL,CĂLĂRAȘI,VLAD ȚEPEȘ,1248,621,627,49.75,50.24,1
50889,CS,CARAȘ-SEVERIN,ANINA,3586,1692,1894,47.18,52.81,1
51243,CS,CARAȘ-SEVERIN,ARMENIȘ,1617,862,755,53.30,46.69,2
50923,CS,CARAȘ-SEVERIN,BĂILE HERCULANE,3270,1583,1687,48.40,51.59,1
51305,CS,CARAȘ-SEVERIN,BĂNIA,895,401,494,44.80,55.19,1
51332,CS,CARAȘ-SEVERIN,BĂUȚAR,1468,768,700,52.31,47.68,2
51387,CS,CARAȘ-SEVERIN,BERLIȘTE,659,366,293,55.53,44.46,2
51449,CS,CARAȘ-SEVERIN,BERZASCA,1256,698,558,55.57,44.42,2
51500,CS,CARAȘ-SEVERIN,BERZOVIA,1500,641,859,42.73,57.26,1
50969,CS,CARAȘ-SEVERIN,BOCȘA,7866,3398,4468,43.19,56.80,1
51546,CS,CARAȘ-SEVERIN,BOLVAȘNIȚA,810,309,501,38.14,61.85,1
51573,CS,CARAȘ-SEVERIN,BOZOVICI,1830,1104,726,60.32,39.67,2
51626,CS,CARAȘ-SEVERIN,BREBU,714,342,372,47.89,52.10,1
51662,CS,CARAȘ-SEVERIN,BREBU NOU,137,34,103,24.81,75.18,1
51699,CS,CARAȘ-SEVERIN,BUCHIN,1128,587,541,52.03,47.96,2
51751,CS,CARAȘ-SEVERIN,BUCOȘNIȚA,1640,1123,517,68.47,31.52,2
51010,CS,CARAȘ-SEVERIN,CARANSEBEȘ,13796,5512,8284,39.95,60.04,1
51804,CS,CARAȘ-SEVERIN,CARAȘOVA,1118,339,779,30.32,69.67,1
51840,CS,CARAȘ-SEVERIN,CĂRBUNARI,610,473,137,77.54,22.45,2
51948,CS,CARAȘ-SEVERIN,CICLOVA ROMÂNĂ,813,473,340,58.17,41.82,2
51984,CS,CARAȘ-SEVERIN,CIUCHICI,628,358,270,57.00,42.99,2
52035,CS,CARAȘ-SEVERIN,CIUDANOVIȚA,336,215,121,63.98,36.01,2
51877,CS,CARAȘ-SEVERIN,CONSTANTIN DAICOVICIU,1625,603,1022,37.10,62.89,1
52062,CS,CARAȘ-SEVERIN,COPĂCELE,648,343,305,52.93,47.06,2
52115,CS,CARAȘ-SEVERIN,CORNEA,1031,434,597,42.09,57.90,1
52160,CS,CARAȘ-SEVERIN,CORNEREVA,1634,897,737,54.89,45.10,2
53489,CS,CARAȘ-SEVERIN,CORONINI,1059,681,378,64.30,35.69,2
52570,CS,CARAȘ-SEVERIN,DALBOȘEȚ,999,559,440,55.95,44.04,2
52650,CS,CARAȘ-SEVERIN,DOCLIN,888,412,476,46.39,53.60,1
52696,CS,CARAȘ-SEVERIN,DOGNECEA,1089,350,739,32.13,67.86,1
52721,CS,CARAȘ-SEVERIN,DOMAȘNEA,766,459,307,59.92,40.07,2
53700,CS,CARAȘ-SEVERIN,EFTIMIE MURGU,996,481,515,48.29,51.70,1
52758,CS,CARAȘ-SEVERIN,EZERIȘ,856,297,559,34.69,65.30,1
52785,CS,CARAȘ-SEVERIN,FÂRLIUG,1399,406,993,29.02,70.97,1
52856,CS,CARAȘ-SEVERIN,FOROTIC,817,369,448,45.16,54.83,1
52909,CS,CARAȘ-SEVERIN,GÂRNIC,797,641,156,80.42,19.57,2
52936,CS,CARAȘ-SEVERIN,GLIMBOCA,1119,319,800,28.50,71.49,1
52954,CS,CARAȘ-SEVERIN,GORUIA,564,287,277,50.88,49.11,2
52990,CS,CARAȘ-SEVERIN,GRĂDINARI,945,454,491,48.04,51.95,1
53023,CS,CARAȘ-SEVERIN,IABLANIȚA,1241,784,457,63.17,36.82,2
53069,CS,CARAȘ-SEVERIN,LĂPUȘNICEL,707,546,161,77.22,22.77,2
53103,CS,CARAȘ-SEVERIN,LĂPUȘNICU MARE,825,451,374,54.66,45.33,2
53130,CS,CARAȘ-SEVERIN,LUNCAVIȚA,1183,505,678,42.68,57.31,1
53167,CS,CARAȘ-SEVERIN,LUPAC,1027,300,727,29.21,70.78,1
53210,CS,CARAȘ-SEVERIN,MARGA,705,535,170,75.88,24.11,2
53247,CS,CARAȘ-SEVERIN,MĂURENI,1186,505,681,42.58,57.41,1
53274,CS,CARAȘ-SEVERIN,MEHADIA,2036,1033,1003,50.73,49.26,2
53327,CS,CARAȘ-SEVERIN,MEHADICA,462,204,258,44.15,55.84,1
51056,CS,CARAȘ-SEVERIN,MOLDOVA NOUĂ,5961,3458,2503,58.01,41.98,2
53345,CS,CARAȘ-SEVERIN,NAIDĂȘ,724,380,344,52.48,47.51,2
53372,CS,CARAȘ-SEVERIN,OBREJA,1820,1030,790,56.59,43.40,2
50987,CS,CARAȘ-SEVERIN,OCNA DE FIER,387,166,221,42.89,57.10,1
51118,CS,CARAȘ-SEVERIN,ORAVIȚA,5760,3016,2744,52.36,47.63,2
51207,CS,CARAȘ-SEVERIN,OȚELU ROȘU,5820,2791,3029,47.95,52.04,1
53425,CS,CARAȘ-SEVERIN,PĂLTINIȘ,1224,433,791,35.37,64.62,1
53513,CS,CARAȘ-SEVERIN,POJEJENA,1723,1235,488,71.67,28.32,2
53577,CS,CARAȘ-SEVERIN,PRIGOR,1464,755,709,51.57,48.42,2
53675,CS,CARAȘ-SEVERIN,RĂCĂȘDIA,744,321,423,43.14,56.85,1
53639,CS,CARAȘ-SEVERIN,RAMNA,801,287,514,35.83,64.16,1
50790,CS,CARAȘ-SEVERIN,REȘIȚA,38156,16679,21477,43.71,56.28,1
53728,CS,CARAȘ-SEVERIN,RUSCA MONTANĂ,958,554,404,57.82,42.17,2
53755,CS,CARAȘ-SEVERIN,SACU,820,345,475,42.07,57.92,1
53791,CS,CARAȘ-SEVERIN,SASCA MONTANĂ,888,468,420,52.70,47.29,2
53853,CS,CARAȘ-SEVERIN,SICHEVIȚA,1316,598,718,45.44,54.55,1
54056,CS,CARAȘ-SEVERIN,SLATINA-TIMIȘ,1540,755,785,49.02,50.97,1
54109,CS,CARAȘ-SEVERIN,SOCOL,1188,877,311,73.82,26.17,2
54163,CS,CARAȘ-SEVERIN,ȘOPOTU NOU,613,364,249,59.38,40.61,2
54350,CS,CARAȘ-SEVERIN,TÂRNOVA,817,391,426,47.85,52.14,1
54270,CS,CARAȘ-SEVERIN,TEREGOVA,2460,1708,752,69.43,30.56,2
54305,CS,CARAȘ-SEVERIN,TICVANIU MARE,828,456,372,55.07,44.92,2
54387,CS,CARAȘ-SEVERIN,TOPLEȚ,1327,609,718,45.89,54.10,1
54412,CS,CARAȘ-SEVERIN,TURNU RUIENI,1679,645,1034,38.41,61.58,1
54485,CS,CARAȘ-SEVERIN,VĂLIUG,475,189,286,39.78,60.21,1
54500,CS,CARAȘ-SEVERIN,VĂRĂDIA,701,426,275,60.77,39.22,2
54537,CS,CARAȘ-SEVERIN,VERMEȘ,958,543,415,56.68,43.31,2
54573,CS,CARAȘ-SEVERIN,VRANI,622,325,297,52.25,47.74,2
54617,CS,CARAȘ-SEVERIN,ZĂVOI,2217,1286,931,58.00,41.99,2
54699,CS,CARAȘ-SEVERIN,ZORLENȚU MARE,579,172,407,29.70,70.29,1
55473,CJ,CLUJ,AGHIREȘU,3305,711,2594,21.51,78.48,1
55598,CJ,CLUJ,AITON,688,245,443,35.61,64.38,1
55623,CJ,CLUJ,ALUNIȘ,603,193,410,32.00,67.99,1
55687,CJ,CLUJ,APAHIDA,6391,1650,4741,25.81,74.18,1
55776,CJ,CLUJ,AȘCHILEU,814,318,496,39.06,60.93,1
55838,CJ,CLUJ,BACIU,5870,1246,4624,21.22,78.77,1
55918,CJ,CLUJ,BĂIȘOARA,1292,371,921,28.71,71.28,1
56014,CJ,CLUJ,BELIȘ,1157,378,779,32.67,67.32,1
56096,CJ,CLUJ,BOBÂLNA,933,514,419,55.09,44.90,2
56210,CJ,CLUJ,BONȚIDA,2453,583,1870,23.76,76.23,1
56265,CJ,CLUJ,BORȘA,1088,193,895,17.73,82.26,1
56327,CJ,CLUJ,BUZA,605,147,458,24.29,75.70,1
56354,CJ,CLUJ,CĂIANU,1182,280,902,23.68,76.31,1
56425,CJ,CLUJ,CĂLĂRAȘI,1126,282,844,25.04,74.95,1
56461,CJ,CLUJ,CĂLĂȚELE,1385,455,930,32.85,67.14,1
56522,CJ,CLUJ,CĂMĂRAȘU,1237,670,567,54.16,45.83,2
55357,CJ,CLUJ,CÂMPIA TURZII,13141,4525,8616,34.43,65.56,1
56568,CJ,CLUJ,CĂPUȘU MARE,1834,453,1381,24.70,75.29,1
56666,CJ,CLUJ,CĂȘEIU,2355,1043,1312,44.28,55.71,1
57314,CJ,CLUJ,CÂȚCĂU,1491,422,1069,28.30,71.69,1
56773,CJ,CLUJ,CĂTINA,885,375,510,42.37,57.62,1
56844,CJ,CLUJ,CEANU MARE,1731,604,1127,34.89,65.10,1
56988,CJ,CLUJ,CHINTENI,1865,676,1189,36.24,63.75,1
57083,CJ,CLUJ,CHIUIEȘTI,1456,408,1048,28.02,71.97,1
57163,CJ,CLUJ,CIUCEA,955,340,615,35.60,64.39,1
57225,CJ,CLUJ,CIURILA,908,270,638,29.73,70.26,1
54975,CJ,CLUJ,CLUJ-NAPOCA,207574,45527,162047,21.93,78.06,1
57350,CJ,CLUJ,COJOCNA,2081,601,1480,28.88,71.11,1
57449,CJ,CLUJ,CORNEȘTI,955,452,503,47.32,52.67,1
55062,CJ,CLUJ,CUZDRIOARA,1356,599,757,44.17,55.82,1
57546,CJ,CLUJ,DĂBÂCA,783,257,526,32.82,67.17,1
55008,CJ,CLUJ,DEJ,19966,7327,12639,36.69,63.30,1
57582,CJ,CLUJ,FELEACU,2114,296,1818,14.00,85.99,1
57644,CJ,CLUJ,FIZEȘU GHERLII,1079,375,704,34.75,65.24,1
57706,CJ,CLUJ,FLOREȘTI,15596,2681,12915,17.19,82.80,1
57742,CJ,CLUJ,FRATA,1650,607,1043,36.78,63.21,1
57948,CJ,CLUJ,GÂRBĂU,1392,263,1129,18.89,81.10,1
57831,CJ,CLUJ,GEACA,906,274,632,30.24,69.75,1
55384,CJ,CLUJ,GHERLA,11951,4397,7554,36.79,63.20,1
57902,CJ,CLUJ,GILĂU,4783,1284,3499,26.84,73.15,1
55446,CJ,CLUJ,HUEDIN,4685,1112,3573,23.73,76.26,1
58008,CJ,CLUJ,IARA,1900,722,1178,38.00,62.00,1
58142,CJ,CLUJ,ICLOD,2185,757,1428,34.64,65.35,1
58204,CJ,CLUJ,IZVORU CRIȘULUI,827,115,712,13.90,86.09,1
55106,CJ,CLUJ,JICHIȘU DE JOS,748,400,348,53.47,46.52,2
58259,CJ,CLUJ,JUCU,2261,608,1653,26.89,73.10,1
58311,CJ,CLUJ,LUNA,2090,558,1532,26.69,73.30,1
58357,CJ,CLUJ,MĂGURI-RĂCĂTĂU,1109,287,822,25.87,74.12,1
58393,CJ,CLUJ,MĂNĂSTIRENI,929,341,588,36.70,63.29,1
58464,CJ,CLUJ,MĂRGĂU,981,305,676,31.09,68.90,1
58534,CJ,CLUJ,MĂRIȘEL,1010,239,771,23.66,76.33,1
55160,CJ,CLUJ,MICA,2052,704,1348,34.30,65.69,1
55277,CJ,CLUJ,MIHAI VITEAZU,2795,741,2054,26.51,73.48,1
58552,CJ,CLUJ,MINTIU GHERLII,1925,918,1007,47.68,52.31,1
58623,CJ,CLUJ,MOCIU,2009,783,1226,38.97,61.02,1
58721,CJ,CLUJ,MOLDOVENEȘTI,1559,331,1228,21.23,78.76,1
60169,CJ,CLUJ,NEGRENI,1530,364,1166,23.79,76.20,1
58794,CJ,CLUJ,PĂLATCA,590,185,405,31.35,68.64,1
58856,CJ,CLUJ,PANTICEU,831,359,472,43.20,56.79,1
58918,CJ,CLUJ,PETREȘTII DE JOS,986,252,734,25.55,74.44,1
58990,CJ,CLUJ,PLOSCOȘ,366,97,269,26.50,73.49,1
59041,CJ,CLUJ,POIENI,2810,949,1861,33.77,66.22,1
59130,CJ,CLUJ,RECEA-CRISTUR,920,240,680,26.08,73.91,1
59238,CJ,CLUJ,RIȘCA,822,195,627,23.72,76.27,1
59283,CJ,CLUJ,SĂCUIEU,779,142,637,18.22,81.77,1
59434,CJ,CLUJ,SÂNCRAIU,1007,184,823,18.27,81.72,1
55311,CJ,CLUJ,SĂNDULEȘTI,1020,311,709,30.49,69.50,1
59498,CJ,CLUJ,SÂNMĂRTIN,1157,875,282,75.62,24.37,2
59586,CJ,CLUJ,SÂNPAUL,1377,381,996,27.66,72.33,1
59327,CJ,CLUJ,SĂVĂDISLA,2481,434,2047,17.49,82.50,1
59416,CJ,CLUJ,SIC,664,50,614,7.53,92.46,1
59657,CJ,CLUJ,SUATU,865,190,675,21.96,78.03,1
59826,CJ,CLUJ,ȚAGA,995,351,644,35.27,64.72,1
59693,CJ,CLUJ,TRITENII DE JOS,2163,681,1482,31.48,68.51,1
55259,CJ,CLUJ,TURDA,27172,8939,18233,32.89,67.10,1
59764,CJ,CLUJ,TURENI,1208,230,978,19.03,80.96,1
59880,CJ,CLUJ,UNGURAȘ,1234,258,976,20.90,79.09,1
59942,CJ,CLUJ,VAD,1415,404,1011,28.55,71.44,1
60026,CJ,CLUJ,VALEA IERII,639,155,484,24.25,75.74,1
60062,CJ,CLUJ,VIIȘOARA,2668,861,1807,32.27,67.72,1
60099,CJ,CLUJ,VULTURENI,887,219,668,24.68,75.31,1
60598,CT,CONSTANȚA,23 AUGUST,2826,1040,1786,36.80,63.19,1
60883,CT,CONSTANȚA,ADAMCLISI,1270,682,588,53.70,46.29,2
60570,CT,CONSTANȚA,AGIGEA,4774,1863,2911,39.02,60.97,1
60945,CT,CONSTANȚA,ALBEȘTI,1903,666,1237,34.99,65.00,1
61005,CT,CONSTANȚA,ALIMAN,1247,609,638,48.83,51.16,1
63198,CT,CONSTANȚA,AMZACEA,1309,715,594,54.62,45.37,2
61069,CT,CONSTANȚA,BĂNEASA,2613,1158,1455,44.31,55.68,1
63294,CT,CONSTANȚA,BĂRĂGANU,972,505,467,51.95,48.04,2
61121,CT,CONSTANȚA,CASTELU,2335,1027,1308,43.98,56.01,1
61167,CT,CONSTANȚA,CERCHEZU,845,530,315,62.72,37.27,2
60776,CT,CONSTANȚA,CERNAVODĂ,9236,4046,5190,43.80,56.19,1
61210,CT,CONSTANȚA,CHIRNOGENI,1442,748,694,51.87,48.12,2
61256,CT,CONSTANȚA,CIOBANU,1456,676,780,46.42,53.57,1
61283,CT,CONSTANȚA,CIOCÂRLIA,1434,648,786,45.18,54.81,1
61318,CT,CONSTANȚA,COBADIN,3992,2050,1942,51.35,48.64,2
61372,CT,CONSTANȚA,COGEALAC,2644,1480,1164,55.97,44.02,2
61452,CT,CONSTANȚA,COMANA,800,330,470,41.25,58.75,1
60419,CT,CONSTANȚA,CONSTANȚA,181463,72628,108835,40.02,59.97,1
61513,CT,CONSTANȚA,CORBU,2990,1064,1926,35.58,64.41,1
63286,CT,CONSTANȚA,COSTINEȘTI,1908,719,1189,37.68,62.31,1
61559,CT,CONSTANȚA,CRUCEA,1277,676,601,52.93,47.06,2
61620,CT,CONSTANȚA,CUMPĂNA,6962,3099,3863,44.51,55.48,1
63300,CT,CONSTANȚA,CUZA VODA,1379,756,623,54.82,45.17,2
61675,CT,CONSTANȚA,DELENI,1396,787,609,56.37,43.62,2
61737,CT,CONSTANȚA,DOBROMIR,1452,872,580,60.05,39.94,2
63161,CT,CONSTANȚA,DUMBRĂVENI,305,154,151,50.49,49.50,2
60455,CT,CONSTANȚA,EFORIE,6281,2079,4202,33.09,66.90,1
63334,CT,CONSTANȚA,FÂNTÂNELE,928,487,441,52.47,47.52,2
61808,CT,CONSTANȚA,GÂRLICIU,775,439,336,56.64,43.35,2
61826,CT,CONSTANȚA,GHINDĂREȘTI,1042,416,626,39.92,60.07,1
63326,CT,CONSTANȚA,GRĂDINA,697,419,278,60.11,39.88,2
60801,CT,CONSTANȚA,HÂRȘOVA,4768,2721,2047,57.06,42.93,2
63278,CT,CONSTANȚA,HORIA,620,353,267,56.93,43.06,2
61871,CT,CONSTANȚA,INDEPENDENȚA,1481,767,714,51.78,48.21,2
61951,CT,CONSTANȚA,ION CORVIN,1018,606,412,59.52,40.47,2
62020,CT,CONSTANȚA,ISTRIA,1296,525,771,40.50,59.49,1
60632,CT,CONSTANȚA,LIMANU,3276,1244,2032,37.97,62.02,1
62057,CT,CONSTANȚA,LIPNIȚA,1423,645,778,45.32,54.67,1
63152,CT,CONSTANȚA,LUMINA,5012,1894,3118,37.78,62.21,1
60482,CT,CONSTANȚA,MANGALIA,21880,9332,12548,42.65,57.34,1
60847,CT,CONSTANȚA,MEDGIDIA,21593,12272,9321,56.83,43.16,2
62137,CT,CONSTANȚA,MERENI,1130,428,702,37.87,62.12,1
62253,CT,CONSTANȚA,MIHAI VITEAZU,1538,575,963,37.38,62.61,1
62191,CT,CONSTANȚA,MIHAIL KOGĂLNICEANU,5312,1731,3581,32.58,67.41,1
62280,CT,CONSTANȚA,MIRCEA VODĂ,2241,1355,886,60.46,39.53,2
62360,CT,CONSTANȚA,MURFATLAR,6054,2702,3352,44.63,55.36,1
60507,CT,CONSTANȚA,NĂVODARI,19894,8049,11845,40.45,59.54,1
62397,CT,CONSTANȚA,NEGRU VODĂ,2430,1373,1057,56.50,43.49,2
62440,CT,CONSTANȚA,NICOLAE BĂLCESCU,2402,1014,1388,42.21,57.78,1
62486,CT,CONSTANȚA,OLTINA,1276,587,689,46.00,53.99,1
62538,CT,CONSTANȚA,OSTROV,2561,1338,1223,52.24,47.75,2
60687,CT,CONSTANȚA,OVIDIU,8013,3145,4868,39.24,60.75,1
62609,CT,CONSTANȚA,PANTELIMON,826,515,311,62.34,37.65,2
62672,CT,CONSTANȚA,PECINEAGA,1446,674,772,46.61,53.38,1
62707,CT,CONSTANȚA,PEȘTERA,1466,805,661,54.91,45.08,2
62761,CT,CONSTANȚA,POARTA ALBĂ,3372,1706,1666,50.59,49.40,2
62798,CT,CONSTANȚA,RASOVA,1423,817,606,57.41,42.58,2
62878,CT,CONSTANȚA,SĂCELE,1184,509,675,42.98,57.01,1
63318,CT,CONSTANȚA,SALIGNY,1182,627,555,53.04,46.95,2
62823,CT,CONSTANȚA,SARAIU,748,459,289,61.36,38.63,2
62903,CT,CONSTANȚA,SEIMENI,988,414,574,41.90,58.09,1
62949,CT,CONSTANȚA,SILIȘTEA,734,454,280,61.85,38.14,2
62985,CT,CONSTANȚA,TÂRGUȘOR,849,392,457,46.17,53.82,1
60534,CT,CONSTANȚA,TECHIRGHIOL,4606,1591,3015,34.54,65.45,1
63045,CT,CONSTANȚA,TOPALU,1030,567,463,55.04,44.95,2
63072,CT,CONSTANȚA,TOPRAISAR,2919,1562,1357,53.51,46.48,2
63189,CT,CONSTANȚA,TORTOMAN,806,495,311,61.41,38.58,2
60721,CT,CONSTANȚA,TUZLA,3814,1449,2365,37.99,62.00,1
63125,CT,CONSTANȚA,VALU LUI TRAIAN,7983,2852,5131,35.72,64.27,1
63170,CT,CONSTANȚA,VULTURU,308,207,101,67.20,32.79,2
63777,CV,COVASNA,AITA MARE,661,76,585,11.49,88.50,1
65113,CV,COVASNA,ARCUȘ,795,151,644,18.99,81.00,1
63447,CV,COVASNA,BARAOLT,3765,367,3398,9.74,90.25,1
63633,CV,COVASNA,BARCANI,1820,892,928,49.01,50.98,1
63802,CV,COVASNA,BĂȚANI,1511,361,1150,23.89,76.10,1
63866,CV,COVASNA,BELIN,1094,502,592,45.88,54.11,1
65121,CV,COVASNA,BIXAD,608,65,543,10.69,89.30,1
63893,CV,COVASNA,BODOC,981,173,808,17.63,82.36,1
63937,CV,COVASNA,BOROȘNEU MARE,782,212,570,27.10,72.89,1
64041,CV,COVASNA,BRĂDUȚ,1633,433,1200,26.51,73.48,1
64005,CV,COVASNA,BRATEȘ,567,71,496,12.52,87.47,1
64096,CV,COVASNA,BREȚCU,1364,365,999,26.75,73.24,1
64130,CV,COVASNA,CATALINA,1211,233,978,19.24,80.75,1
64194,CV,COVASNA,CERNAT,1357,237,1120,17.46,82.53,1
64238,CV,COVASNA,CHICHIȘ,730,169,561,23.15,76.84,1
63553,CV,COVASNA,COMANDĂU,428,78,350,18.22,81.77,1
63526,CV,COVASNA,COVASNA,6148,1575,4573,25.61,74.38,1
65147,CV,COVASNA,DALNIC,280,78,202,27.85,72.14,1
64265,CV,COVASNA,DOBÂRLĂU,1221,459,762,37.59,62.40,1
65154,CV,COVASNA,ESTELNIC,397,60,337,15.11,84.88,1
64318,CV,COVASNA,GHELINȚA,1563,334,1229,21.36,78.63,1
64345,CV,COVASNA,GHIDFALĂU,873,148,725,16.95,83.04,1
64390,CV,COVASNA,HĂGHIG,1090,536,554,49.17,50.82,1
64425,CV,COVASNA,ILIENI,944,121,823,12.81,87.18,1
63580,CV,COVASNA,ÎNTORSURA BUZĂULUI,4051,1725,2326,42.58,57.41,1
64461,CV,COVASNA,LEMNIA,652,57,595,8.74,91.25,1
64504,CV,COVASNA,MALNAȘ,537,48,489,8.93,91.06,1
65105,CV,COVASNA,MERENI,538,67,471,12.45,87.54,1
65139,CV,COVASNA,MICFALĂU,677,77,600,11.37,88.62,1
64568,CV,COVASNA,MOACȘA,409,59,350,14.42,85.57,1
64602,CV,COVASNA,OJDULA,1167,249,918,21.33,78.66,1
64639,CV,COVASNA,OZUN,1936,313,1623,16.16,83.83,1
64719,CV,COVASNA,POIAN,597,54,543,9.04,90.95,1
64773,CV,COVASNA,RECI,867,139,728,16.03,83.96,1
64826,CV,COVASNA,SÂNZIENI,27473,4902,22571,17.84,82.15,1
63394,CV,COVASNA,SFÂNTU GHEORGHE,1434,216,1218,15.06,84.93,1
63688,CV,COVASNA,SITA BUZĂULUI,2043,918,1125,44.93,55.06,1
63740,CV,COVASNA,TÂRGU SECUIESC,7825,896,6929,11.45,88.54,1
64871,CV,COVASNA,TURIA,1175,295,880,25.10,74.89,1
64942,CV,COVASNA,VÂLCELE,1717,909,808,52.94,47.05,2
64906,CV,COVASNA,VALEA CRIȘULUI,818,157,661,19.19,80.80,1
65099,CV,COVASNA,VALEA MARE,423,263,160,62.17,37.82,2
64997,CV,COVASNA,VÂRGHIȘ,643,50,593,7.77,92.22,1
65048,CV,COVASNA,ZĂBALA,1582,351,1231,22.18,77.81,1
65011,CV,COVASNA,ZAGON,2323,556,1767,23.93,76.06,1
65379,DB,DÂMBOVIȚA,ANINOASA,3612,2226,1386,61.62,38.37,2
66198,DB,DÂMBOVIȚA,BĂLENI,3988,2413,1575,60.50,39.49,2
66223,DB,DÂMBOVIȚA,BĂRBULEȚU,1208,685,523,56.70,43.29,2
66330,DB,DÂMBOVIȚA,BEZDEAD,2357,999,1358,42.38,57.61,1
66401,DB,DÂMBOVIȚA,BILCIUREȘTI,1106,605,501,54.70,45.29,2
66009,DB,DÂMBOVIȚA,BRĂNEȘTI,2232,1122,1110,50.26,49.73,2
66152,DB,DÂMBOVIȚA,BRANIȘTEA,2453,1666,787,67.91,32.08,2
101341,DB,DÂMBOVIȚA,BREZOAELE,2289,1539,750,67.23,32.76,2
66438,DB,DÂMBOVIȚA,BUCIUMENI,2287,1181,1106,51.63,48.36,2
66474,DB,DÂMBOVIȚA,BUCȘANI,3614,2195,1419,60.73,39.26,2
101564,DB,DÂMBOVIȚA,BUTIMANU,1476,950,526,64.36,35.63,2
66526,DB,DÂMBOVIȚA,CÂNDEȘTI,1871,1108,763,59.21,40.78,2
101840,DB,DÂMBOVIȚA,CIOCĂNEȘTI,3188,2196,992,68.88,31.11,2
66580,DB,DÂMBOVIȚA,COBIA,1938,1406,532,72.54,27.45,2
66697,DB,DÂMBOVIȚA,COJASCA,3134,2211,923,70.54,29.45,2
66731,DB,DÂMBOVIȚA,COMIȘANI,2805,1784,1021,63.60,36.39,2
66768,DB,DÂMBOVIȚA,CONȚEȘTI,2316,1554,762,67.09,32.90,2
66857,DB,DÂMBOVIȚA,CORBII MARI,4263,2747,1516,64.43,35.56,2
66955,DB,DÂMBOVIȚA,CORNĂȚELU,1181,849,332,71.88,28.11,2
67014,DB,DÂMBOVIȚA,CORNEȘTI,3933,2155,1778,54.79,45.20,2
67121,DB,DÂMBOVIȚA,COSTEȘTII DIN VALE,1754,1334,420,76.05,23.94,2
67167,DB,DÂMBOVIȚA,CRÂNGURILE,1705,1219,486,71.49,28.50,2
102286,DB,DÂMBOVIȚA,CREVEDIA,4079,2031,2048,49.79,50.20,1
67256,DB,DÂMBOVIȚA,DĂRMĂNEȘTI,2502,1236,1266,49.40,50.59,1
67292,DB,DÂMBOVIȚA,DOBRA,2009,1289,720,64.16,35.83,2
65413,DB,DÂMBOVIȚA,DOICEȘTI,2256,1365,891,60.50,39.49,2
67327,DB,DÂMBOVIȚA,DRAGODANA,3284,1895,1389,57.70,42.29,2
67407,DB,DÂMBOVIȚA,DRAGOMIREȘTI,4460,2552,1908,57.21,42.78,2
65609,DB,DÂMBOVIȚA,FIENI,3624,1414,2210,39.01,60.98,1
67470,DB,DÂMBOVIȚA,FINTA,2281,1083,1198,47.47,52.52,1
65681,DB,DÂMBOVIȚA,GĂEȘTI,8723,5193,3530,59.53,40.46,2
67522,DB,DÂMBOVIȚA,GLODENI,2144,1175,969,54.80,45.19,2
65707,DB,DÂMBOVIȚA,GURA FOII,1440,1002,438,69.58,30.41,2
67595,DB,DÂMBOVIȚA,GURA OCNIȚEI,3780,2272,1508,60.10,39.89,2
67648,DB,DÂMBOVIȚA,GURA ȘUȚII,2697,1907,790,70.70,29.29,2
67675,DB,DÂMBOVIȚA,HULUBEȘTI,1825,1241,584,68.00,32.00,2
67737,DB,DÂMBOVIȚA,I. L. CARAGIALE,4227,3095,1132,73.21,26.78,2
65869,DB,DÂMBOVIȚA,IEDERA,2026,1196,830,59.03,40.96,2
67773,DB,DÂMBOVIȚA,LUCIENI,1567,888,679,56.66,43.33,2
67835,DB,DÂMBOVIȚA,LUDEȘTI,2511,1677,834,66.78,33.21,2
67906,DB,DÂMBOVIȚA,LUNGULEȚU,2723,1871,852,68.71,31.28,2
67942,DB,DÂMBOVIȚA,MALU CU FLORI,1555,1055,500,67.84,32.15,2
68002,DB,DÂMBOVIȚA,MĂNEȘTI,2541,1601,940,63.00,36.99,2
68048,DB,DÂMBOVIȚA,MĂTĂSARU,2687,1921,766,71.49,28.50,2
68128,DB,DÂMBOVIȚA,MOGOȘANI,2505,1320,1185,52.69,47.30,2
65841,DB,DÂMBOVIȚA,MORENI,10283,5265,5018,51.20,48.79,2
68182,DB,DÂMBOVIȚA,MOROENI,2819,1573,1246,55.79,44.20,2
68253,DB,DÂMBOVIȚA,MORTENI,1738,1206,532,69.39,30.60,2
65645,DB,DÂMBOVIȚA,MOȚĂIENI,1220,543,677,44.50,55.49,1
104387,DB,DÂMBOVIȚA,NICULEȘTI,2445,1690,755,69.12,30.87,2
68280,DB,DÂMBOVIȚA,NUCET,2399,1681,718,70.07,29.92,2
68324,DB,DÂMBOVIȚA,OCNIȚA,2122,1159,963,54.61,45.38,2
68342,DB,DÂMBOVIȚA,ODOBEȘTI,2747,1969,778,71.67,28.32,2
179935,DB,DÂMBOVIȚA,PERȘINARI,1421,900,521,63.33,36.66,2
65752,DB,DÂMBOVIȚA,PETREȘTI,3311,1971,1340,59.52,40.47,2
179908,DB,DÂMBOVIȚA,PIETRARI,1424,810,614,56.88,43.11,2
68404,DB,DÂMBOVIȚA,PIETROȘIȚA,1800,980,820,54.44,45.55,2
68431,DB,DÂMBOVIȚA,POIANA,2042,1402,640,68.65,31.34,2
68468,DB,DÂMBOVIȚA,POTLOGI,3894,2845,1049,73.06,26.93,2
68529,DB,DÂMBOVIȚA,PRODULEȘTI,1838,1218,620,66.26,33.73,2
68565,DB,DÂMBOVIȚA,PUCHENI,1139,803,336,70.50,29.49,2
65921,DB,DÂMBOVIȚA,PUCIOASA,8219,3943,4276,47.97,52.02,1
68627,DB,DÂMBOVIȚA,RĂCARI,4076,2134,1942,52.35,47.64,2
179891,DB,DÂMBOVIȚA,RACIU,1828,1133,695,61.98,38.01,2
179926,DB,DÂMBOVIȚA,RĂSCĂEȚI,1423,1080,343,75.89,24.10,2
179917,DB,DÂMBOVIȚA,RÂU ALB,865,555,310,64.16,35.83,2
65431,DB,DÂMBOVIȚA,RĂZVAD,4926,2485,2441,50.44,49.55,2
68716,DB,DÂMBOVIȚA,RUNCU,2142,1210,932,56.48,43.51,2
68789,DB,DÂMBOVIȚA,SĂLCIOARA,2203,1462,741,66.36,33.63,2
68887,DB,DÂMBOVIȚA,ȘELARU,1845,1358,487,73.60,26.39,2
105142,DB,DÂMBOVIȚA,SLOBOZIA MOARĂ,1221,856,365,70.10,29.89,2
65477,DB,DÂMBOVIȚA,ȘOTÂNGA,3583,2413,1170,67.34,32.65,2
65342,DB,DÂMBOVIȚA,TÂRGOVIȘTE,45556,20623,24933,45.26,54.73,1
105534,DB,DÂMBOVIȚA,TĂRTĂȘEȘTI,3465,1950,1515,56.27,43.72,2
68921,DB,DÂMBOVIȚA,TĂTĂRANI,3201,2122,1079,66.29,33.70,2
66081,DB,DÂMBOVIȚA,TITU,5687,3743,1944,65.81,34.18,2
68976,DB,DÂMBOVIȚA,ULIEȘTI,2498,1705,793,68.25,31.74,2
65501,DB,DÂMBOVIȚA,ULMI,2282,1302,980,57.05,42.94,2
69250,DB,DÂMBOVIȚA,VĂCĂREȘTI,2568,1435,1133,55.88,44.11,2
69063,DB,DÂMBOVIȚA,VALEA LUNGĂ,2559,1466,1093,57.28,42.71,2
69170,DB,DÂMBOVIȚA,VALEA MARE,1393,994,399,71.35,28.64,2
69303,DB,DÂMBOVIȚA,VĂLENI-DÂMBOVIȚA,1478,887,591,60.01,39.98,2
69447,DB,DÂMBOVIȚA,VÂRFURI,899,472,427,52.50,47.49,2
69330,DB,DÂMBOVIȚA,VIȘINA,2242,1451,791,64.71,35.28,2
69394,DB,DÂMBOVIȚA,VIȘINEȘTI,1177,692,485,58.79,41.20,2
179711,DB,DÂMBOVIȚA,VLĂDENI,1466,678,788,46.24,53.75,1
69526,DB,DÂMBOVIȚA,VOINEȘTI,3631,2404,1227,66.20,33.79,2
69615,DB,DÂMBOVIȚA,VULCANA-BĂI,1490,803,687,53.89,46.10,2
179640,DB,DÂMBOVIȚA,VULCANA-PANDELE,2420,1493,927,61.69,38.30,2
70520,DJ,DOLJ,AFUMAȚI,1559,1012,547,64.91,35.08,2
70566,DJ,DOLJ,ALMĂJ,1335,748,587,56.02,43.97,2
70637,DJ,DOLJ,AMĂRĂȘTII DE JOS,3107,2254,853,72.54,27.45,2
70673,DJ,DOLJ,AMĂRĂȘTII DE SUS,1291,1026,265,79.47,20.52,2
70726,DJ,DOLJ,APELE VII,1399,672,727,48.03,51.96,1
70744,DJ,DOLJ,ARGETOAIA,2768,2160,608,78.03,21.96,2
70316,DJ,DOLJ,BĂILEȘTI,7682,4503,3179,58.61,41.38,2
70940,DJ,DOLJ,BÂRCA,1933,1157,776,59.85,40.14,2
70879,DJ,DOLJ,BECHET,1840,1296,544,70.43,29.56,2
70897,DJ,DOLJ,BISTREȚ,2538,1930,608,76.04,23.95,2
70968,DJ,DOLJ,BOTOȘEȘTI-PAIA,596,461,135,77.34,22.65,2
70986,DJ,DOLJ,BRABOVA,923,669,254,72.48,27.51,2
71055,DJ,DOLJ,BRĂDEȘTI,2774,2081,693,75.01,24.98,2
71126,DJ,DOLJ,BRALOȘTIȚA,1936,1152,784,59.50,40.49,2
71199,DJ,DOLJ,BRATOVOEȘTI,2060,1522,538,73.88,26.11,2
71260,DJ,DOLJ,BREASTA,1828,933,895,51.03,48.96,2
69964,DJ,DOLJ,BUCOVĂȚ,2480,1508,972,60.80,39.19,2
71340,DJ,DOLJ,BULZEȘTI,975,689,286,70.66,29.33,2
70352,DJ,DOLJ,CALAFAT,8327,5462,2865,65.59,34.40,2
71607,DJ,DOLJ,CĂLĂRAȘI,3513,2600,913,74.01,25.98,2
71457,DJ,DOLJ,CALOPĂR,1835,1356,479,73.89,26.10,2
71518,DJ,DOLJ,CARAULA,1389,1201,188,86.46,13.53,2
74859,DJ,DOLJ,CÂRCEA,1639,1033,606,63.02,36.97,2
74867,DJ,DOLJ,CÂRNA,824,546,278,66.26,33.73,2
71536,DJ,DOLJ,CARPEN,1623,1405,218,86.56,13.43,2
71572,DJ,DOLJ,CASTRANOVA,1842,974,868,52.87,47.12,2
74842,DJ,DOLJ,CATANE,939,708,231,75.39,24.60,2
71634,DJ,DOLJ,CELARU,2466,1743,723,70.68,29.31,2
71698,DJ,DOLJ,CERĂT,1741,1348,393,77.42,22.57,2
71723,DJ,DOLJ,CERNĂTEȘTI,1148,791,357,68.90,31.09,2
71787,DJ,DOLJ,CETATE,2990,2523,467,84.38,15.61,2
71812,DJ,DOLJ,CIOROIAȘI,1005,656,349,65.27,34.72,2
71858,DJ,DOLJ,CIUPERCENII NOI,2990,2321,669,77.62,22.37,2
71885,DJ,DOLJ,COȘOVENI,2089,1278,811,61.17,38.82,2
71910,DJ,DOLJ,COȚOFENII DIN DOS,1278,748,530,58.52,41.47,2
74875,DJ,DOLJ,COȚOFENII DIN FAȚĂ,1147,769,378,67.04,32.95,2
69900,DJ,DOLJ,CRAIOVA,155861,78660,77201,50.46,49.53,2
72007,DJ,DOLJ,DĂBULENI,7704,5508,2196,71.49,28.50,2
71956,DJ,DOLJ,DANEȚI,2951,1652,1299,55.98,44.01,2
72034,DJ,DOLJ,DESA,2385,1862,523,78.07,21.92,2
72052,DJ,DOLJ,DIOȘTI,1715,1205,510,70.26,29.73,2
72098,DJ,DOLJ,DOBREȘTI,1460,996,464,68.21,31.78,2
74883,DJ,DOLJ,DOBROTEȘTI,961,595,366,61.91,38.08,2
72150,DJ,DOLJ,DRĂGOTEȘTI,1510,1105,405,73.17,26.82,2
72221,DJ,DOLJ,DRĂNIC,1666,932,734,55.94,44.05,2
72276,DJ,DOLJ,FĂRCAȘ,1181,928,253,78.57,21.42,2
70414,DJ,DOLJ,FILIAȘI,8489,5386,3103,63.44,36.55,2
72383,DJ,DOLJ,GALICEA MARE,2355,1175,1180,49.89,50.10,1
74891,DJ,DOLJ,GALICIUICA,1089,858,231,78.78,21.21,2
72579,DJ,DOLJ,GÂNGIOVA,1193,867,326,72.67,27.32,2
72409,DJ,DOLJ,GHERCEȘTI,1502,878,624,58.45,41.54,2
74907,DJ,DOLJ,GHIDICI,1427,1196,231,83.81,16.18,2
74915,DJ,DOLJ,GHINDENI,1325,574,751,43.32,56.67,1
72463,DJ,DOLJ,GIGHERA,1636,1255,381,76.71,23.28,2
72506,DJ,DOLJ,GIUBEGA,1071,467,604,43.60,56.39,1
72533,DJ,DOLJ,GIURGIȚA,1683,1351,332,80.27,19.72,2
72604,DJ,DOLJ,GOGOȘU,809,461,348,56.98,43.01,2
72640,DJ,DOLJ,GOICEA,1797,1234,563,68.67,31.32,2
72677,DJ,DOLJ,GOIEȘTI,1775,802,973,45.18,54.81,1
72819,DJ,DOLJ,GRECEȘTI,1158,833,325,71.93,28.06,2
74923,DJ,DOLJ,ÎNTORSURA,920,680,240,73.91,26.08,2
70094,DJ,DOLJ,IȘALNIȚA,3014,2171,843,72.03,27.96,2
72882,DJ,DOLJ,IZVOARE,1085,624,461,57.51,42.48,2
72926,DJ,DOLJ,LEU,2899,1923,976,66.33,33.66,2
72953,DJ,DOLJ,LIPOVU,1023,820,203,80.15,19.84,2
72980,DJ,DOLJ,MĂCEȘU DE JOS,861,648,213,75.26,24.73,2
73013,DJ,DOLJ,MĂCEȘU DE SUS,896,486,410,54.24,45.75,2
73031,DJ,DOLJ,MAGLAVIT,2845,2208,637,77.60,22.39,2
73068,DJ,DOLJ,MALU MARE,2027,1196,831,59.00,40.99,2
73317,DJ,DOLJ,MÂRȘANI,3217,2476,741,76.96,23.03,2
73102,DJ,DOLJ,MELINEȘTI,2256,1508,748,66.84,33.15,2
73246,DJ,DOLJ,MISCHII,1372,684,688,49.85,50.14,1
73335,DJ,DOLJ,MOȚĂȚEI,3488,2465,1023,70.67,29.32,2
73371,DJ,DOLJ,MURGAȘI,1573,942,631,59.88,40.11,2
73460,DJ,DOLJ,NEGOI,1205,967,238,80.24,19.75,2
73503,DJ,DOLJ,ORODEL,1706,1350,356,79.13,20.86,2
73567,DJ,DOLJ,OSTROVENI,2621,2198,423,83.86,16.13,2
73594,DJ,DOLJ,PERIȘOR,1005,661,344,65.77,34.22,2
73629,DJ,DOLJ,PIELEȘTI,1690,867,823,51.30,48.69,2
73665,DJ,DOLJ,PISCU VECHI,1568,1080,488,68.87,31.12,2
73709,DJ,DOLJ,PLENIȚA,2519,1754,765,69.63,30.36,2
74931,DJ,DOLJ,PLEȘOI,854,759,95,88.87,11.12,2
70110,DJ,DOLJ,PODARI,3151,2346,805,74.45,25.54,2
73736,DJ,DOLJ,POIANA MARE,5343,3663,1680,68.55,31.44,2
73772,DJ,DOLJ,PREDEȘTI,996,408,588,40.96,59.03,1
73852,DJ,DOLJ,RADOVAN,855,586,269,68.53,31.46,2
73905,DJ,DOLJ,RAST,1880,1331,549,70.79,29.20,2
73923,DJ,DOLJ,ROBĂNEȘTI,1330,898,432,67.51,32.48,2
74949,DJ,DOLJ,ROJIȘTE,1525,603,922,39.54,60.45,1
73996,DJ,DOLJ,SADOVA,3686,1884,1802,51.11,48.88,2
74028,DJ,DOLJ,SĂLCUȚA,891,618,273,69.36,30.63,2
74073,DJ,DOLJ,SCĂEȘTI,1181,688,493,58.25,41.74,2
74108,DJ,DOLJ,SEACA DE CÂMP,1328,966,362,72.74,27.25,2
74135,DJ,DOLJ,SEACA DE PĂDURE,834,711,123,85.25,14.74,2
74171,DJ,DOLJ,SECU,643,333,310,51.78,48.21,2
70502,DJ,DOLJ,SEGARCEA,3614,2739,875,75.78,24.21,2
74224,DJ,DOLJ,SILIȘTEA CRUCII,1013,495,518,48.86,51.13,1
70174,DJ,DOLJ,ȘIMNICU DE SUS,2590,1464,1126,56.52,43.47,2
74242,DJ,DOLJ,SOPOT,1043,706,337,67.68,32.31,2
74956,DJ,DOLJ,TĂLPAȘ,769,533,236,69.31,30.68,2
74322,DJ,DOLJ,TEASC,1832,1153,679,62.93,37.06,2
74359,DJ,DOLJ,TERPEZIȚA,1574,1175,399,74.65,25.34,2
74411,DJ,DOLJ,TESLUI,1447,938,509,64.82,35.17,2
74509,DJ,DOLJ,ȚUGLUI,1702,1208,494,70.97,29.02,2
74536,DJ,DOLJ,UNIREA,2376,1715,661,72.18,27.81,2
74554,DJ,DOLJ,URZICUȚA,1447,1142,305,78.92,21.07,2
74581,DJ,DOLJ,VALEA STANCIULUI,2974,2056,918,69.13,30.86,2
74732,DJ,DOLJ,VÂRTOP,953,816,137,85.62,14.37,2
74750,DJ,DOLJ,VÂRVORU DE JOS,1796,1333,463,74.22,25.77,2
74616,DJ,DOLJ,VELA,1411,1121,290,79.44,20.55,2
74705,DJ,DOLJ,VERBIȚA,723,585,138,80.91,19.08,2
75542,GL,GALAȚI,BĂLĂBĂNEȘTI,1121,807,314,71.98,28.01,2
75613,GL,GALAȚI,BĂLĂȘEȘTI,1263,920,343,72.84,27.15,2
75668,GL,GALAȚI,BĂLENI,1198,848,350,70.78,29.21,2
75686,GL,GALAȚI,BĂNEASA,1093,671,422,61.39,38.60,2
75515,GL,GALAȚI,BARCEA,2821,1135,1686,40.23,59.76,1
75338,GL,GALAȚI,BEREȘTI,1602,1191,411,74.34,25.65,2
75356,GL,GALAȚI,BEREȘTI-MERIA,1922,1377,545,71.64,28.35,2
75766,GL,GALAȚI,BRĂHĂȘEȘTI,2682,2300,382,85.75,14.24,2
75711,GL,GALAȚI,BRANIȘTEA,2055,1031,1024,50.17,49.82,2
75819,GL,GALAȚI,BUCIUMENI,1263,726,537,57.48,42.51,2
75864,GL,GALAȚI,CAVADINEȘTI,1631,1284,347,78.72,21.27,2
75917,GL,GALAȚI,CERȚEȘTI,1331,588,743,44.17,55.82,1
76004,GL,GALAȚI,CORNI,1182,678,504,57.36,42.63,2
75953,GL,GALAȚI,COROD,3177,1388,1789,43.68,56.31,1
76040,GL,GALAȚI,COSMEȘTI,2939,1811,1128,61.61,38.38,2
76111,GL,GALAȚI,COSTACHE NEGRI,1386,833,553,60.10,39.89,2
76139,GL,GALAȚI,CUCA,1220,870,350,71.31,28.68,2
76157,GL,GALAȚI,CUDALBI,3487,2260,1227,64.81,35.18,2
77595,GL,GALAȚI,CUZA VODĂ,1447,992,455,68.55,31.44,2
75221,GL,GALAȚI,DRĂGĂNEȘTI,2733,1201,1532,43.94,56.05,1
76175,GL,GALAȚI,DRĂGUȘENI,2282,1476,806,64.68,35.31,2
76255,GL,GALAȚI,FÂRȚĂNEȘTI,2375,1893,482,79.70,20.29,2
76282,GL,GALAȚI,FOLTEȘTI,1581,1078,503,68.18,31.81,2
76317,GL,GALAȚI,FRUMUȘIȚA,2283,1632,651,71.48,28.51,2
76353,GL,GALAȚI,FUNDENI,2079,1166,913,56.08,43.91,2
75098,GL,GALAȚI,GALAȚI,147888,71788,76100,48.54,51.45,1
76406,GL,GALAȚI,GHIDIGENI,3017,1372,1645,45.47,54.52,1
76497,GL,GALAȚI,GOHOR,1720,1147,573,66.68,33.31,2
76558,GL,GALAȚI,GRIVIȚA,1640,931,709,56.76,43.23,2
76585,GL,GALAȚI,INDEPENDENȚA,2383,1345,1038,56.44,43.55,2
76601,GL,GALAȚI,IVEȘTI,4413,3078,1335,69.74,30.25,2
76638,GL,GALAȚI,JORĂȘTI,920,631,289,68.58,31.41,2
76674,GL,GALAȚI,LIEȘTI,4926,2042,2884,41.45,58.54,1
76718,GL,GALAȚI,MĂSTĂCANI,2191,1571,620,71.70,28.29,2
76692,GL,GALAȚI,MATCA,5618,2012,3606,35.81,64.18,1
76745,GL,GALAȚI,MOVILENI,1274,654,620,51.33,48.66,2
75258,GL,GALAȚI,MUNTENI,3491,1753,1738,50.21,49.78,2
76763,GL,GALAȚI,NĂMOLOASA,1269,947,322,74.62,25.37,2
77579,GL,GALAȚI,NEGRILEȘTI,1479,981,498,66.32,33.67,2
76807,GL,GALAȚI,NICOREȘTI,2071,825,1246,39.83,60.16,1
76932,GL,GALAȚI,OANCEA,964,397,567,41.18,58.81,1
76969,GL,GALAȚI,PECHEA,4937,3265,1672,66.13,33.86,2
76996,GL,GALAȚI,PISCU,2514,1519,995,60.42,39.57,2
77587,GL,GALAȚI,POIANA,1033,706,327,68.34,31.65,2
77028,GL,GALAȚI,PRIPONEȘTI,1081,763,318,70.58,29.41,2
77561,GL,GALAȚI,RĂDEȘTI,776,601,175,77.44,22.55,2
77082,GL,GALAȚI,REDIU,1195,840,355,70.29,29.70,2
77126,GL,GALAȚI,SCÂNTEIEȘTI,1311,943,368,71.92,28.07,2
77153,GL,GALAȚI,SCHELA,2127,1333,794,62.67,37.32,2
75114,GL,GALAȚI,ȘENDRENI,2390,1121,1269,46.90,53.09,1
77180,GL,GALAȚI,SLOBOZIA CONACHI,2245,1461,784,65.07,34.92,2
77224,GL,GALAȚI,SMÂRDAN,2553,1605,948,62.86,37.13,2
77260,GL,GALAȚI,SMULȚI,788,594,194,75.38,24.61,2
77288,GL,GALAȚI,SUCEVENI,1145,803,342,70.13,29.86,2
77601,GL,GALAȚI,SUHURLUI,672,375,297,55.80,44.19,2
75472,GL,GALAȚI,TÂRGU BUJOR,3736,2727,1009,72.99,27.00,2
75203,GL,GALAȚI,TECUCI,20196,10902,9294,53.98,46.01,2
77377,GL,GALAȚI,ȚEPU,1332,677,655,50.82,49.17,2
77313,GL,GALAȚI,TUDOR VLADIMIRESCU,2737,1653,1084,60.39,39.60,2
77331,GL,GALAȚI,TULUCEȘTI,3530,2145,1385,60.76,39.23,2
77402,GL,GALAȚI,UMBRĂREȘTI,2987,1839,1148,61.56,38.43,2
77475,GL,GALAȚI,VALEA MĂRULUI,1868,1365,503,73.07,26.92,2
75150,GL,GALAȚI,VÂNĂTORI,2949,1648,1301,55.88,44.11,2
77509,GL,GALAȚI,VÂRLEZI,1173,808,365,68.88,31.11,2
77536,GL,GALAȚI,VLĂDEȘTI,1215,688,527,56.62,43.37,2
100781,GR,GIURGIU,ADUNAȚII-COPĂCENI,3439,2064,1375,60.01,39.98,2
101001,GR,GIURGIU,BĂNEASA,2895,2190,705,75.64,24.35,2
101163,GR,GIURGIU,BOLINTIN-DEAL,2939,1191,1748,40.52,59.47,1
101190,GR,GIURGIU,BOLINTIN-VALE,5439,2989,2450,54.95,45.04,2
101378,GR,GIURGIU,BUCȘANI,2118,1549,569,73.13,26.86,2
101519,GR,GIURGIU,BULBUCATA,1074,796,278,74.11,25.88,2
101617,GR,GIURGIU,BUTURUGENI,2356,1487,869,63.11,36.88,2
101662,GR,GIURGIU,CĂLUGĂRENI,3433,2363,1070,68.83,31.16,2
101984,GR,GIURGIU,CLEJANI,2364,1907,457,80.66,19.33,2
102071,GR,GIURGIU,COLIBAȘI,2328,1670,658,71.73,28.26,2
102106,GR,GIURGIU,COMANA,4728,3510,1218,74.23,25.76,2
179748,GR,GIURGIU,COSOBA,1279,673,606,52.61,47.38,2
102348,GR,GIURGIU,CREVEDIA MARE,2527,1820,707,72.02,27.97,2
102446,GR,GIURGIU,DAIA,1346,882,464,65.52,34.47,2
102794,GR,GIURGIU,FLOREȘTI-STOENEȘTI,3949,1725,2224,43.68,56.31,1
102909,GR,GIURGIU,FRĂTEȘTI,2722,1992,730,73.18,26.81,2
103087,GR,GIURGIU,GĂISENI,2655,1857,798,69.94,30.05,2
103194,GR,GIURGIU,GĂUJANI,1202,980,222,81.53,18.46,2
103238,GR,GIURGIU,GHIMPAȚI,4001,3345,656,83.60,16.39,2
100521,GR,GIURGIU,GIURGIU,33578,22843,10735,68.02,31.97,2
103309,GR,GIURGIU,GOGOȘARI,976,707,269,72.43,27.56,2
103372,GR,GIURGIU,GOSTINARI,1556,961,595,61.76,38.23,2
103354,GR,GIURGIU,GOSTINU,1379,1141,238,82.74,17.25,2
103407,GR,GIURGIU,GRĂDINARI,1736,1095,641,63.07,36.92,2
103470,GR,GIURGIU,GREACA,1421,1012,409,71.21,28.78,2
179757,GR,GIURGIU,HERĂȘTI,1176,757,419,64.37,35.62,2
103639,GR,GIURGIU,HOTARELE,2107,1374,733,65.21,34.78,2
103693,GR,GIURGIU,IEPUREȘTI,1470,1042,428,70.88,29.11,2
179766,GR,GIURGIU,ISVOARELE,895,651,244,72.73,27.26,2
103899,GR,GIURGIU,IZVOARELE,2105,1613,492,76.62,23.37,2
103997,GR,GIURGIU,JOIȚA,2081,1047,1034,50.31,49.68,2
104047,GR,GIURGIU,LETCA NOUĂ,1804,1380,424,76.49,23.50,2
179739,GR,GIURGIU,MALU,1221,923,298,75.59,24.40,2
104225,GR,GIURGIU,MÂRȘA,1458,1114,344,76.40,23.59,2
104118,GR,GIURGIU,MIHAI BRAVU,1640,1263,377,77.01,22.98,2
104136,GR,GIURGIU,MIHĂILEȘTI,5434,3789,1645,69.72,30.27,2
104485,GR,GIURGIU,OGREZENI,2321,1362,959,58.68,41.31,2
104519,GR,GIURGIU,OINACU,1835,1273,562,69.37,30.62,2
104680,GR,GIURGIU,PRUNDU,2736,2261,475,82.63,17.36,2
104715,GR,GIURGIU,PUTINEIU,1584,1340,244,84.59,15.40,2
104788,GR,GIURGIU,RĂSUCENI,1583,1413,170,89.26,10.73,2
104831,GR,GIURGIU,ROATA DE JOS,3808,2694,1114,70.74,29.25,2
179775,GR,GIURGIU,SĂBĂRENI,1750,851,899,48.62,51.37,1
104975,GR,GIURGIU,SCHITU,1101,825,276,74.93,25.06,2
105106,GR,GIURGIU,SINGURENI,2007,1482,525,73.84,26.15,2
100549,GR,GIURGIU,SLOBOZIA,1191,946,245,79.42,20.57,2
105295,GR,GIURGIU,STĂNEȘTI,1565,1288,277,82.30,17.69,2
105348,GR,GIURGIU,STOENEȘTI,1576,1246,330,79.06,20.93,2
154709,GR,GIURGIU,TOPORU,1329,1053,276,79.23,20.76,2
105623,GR,GIURGIU,ULMI,3832,2080,1752,54.27,45.72,2
105776,GR,GIURGIU,VALEA DRAGULUI,1740,1050,690,60.34,39.65,2
105972,GR,GIURGIU,VÂNĂTORII MICI,2372,1704,668,71.83,28.16,2
105874,GR,GIURGIU,VĂRĂȘTI,2754,1776,978,64.48,35.51,2
105909,GR,GIURGIU,VEDEA,1310,1060,250,80.91,19.08,2
78472,GJ,GORJ,ALBENI,1307,839,468,64.19,35.80,2
78542,GJ,GORJ,ALIMPEȘTI,1081,678,403,62.71,37.28,2
78604,GJ,GORJ,ANINOASA,1960,1346,614,68.67,31.32,2
78668,GJ,GORJ,ARCANI,868,430,438,49.53,50.46,1
78711,GJ,GORJ,BAIA DE FIER,2317,1651,666,71.25,28.74,2
78748,GJ,GORJ,BĂLĂNEȘTI,1459,1045,414,71.62,28.37,2
77910,GJ,GORJ,BĂLEȘTI,4030,2332,1698,57.86,42.13,2
79004,GJ,GORJ,BÂLTENI,3903,2097,1806,53.72,46.27,2
78828,GJ,GORJ,BĂRBĂTEȘTI,966,521,445,53.93,46.06,2
78873,GJ,GORJ,BENGEȘTI-CIOCADIA,1594,1089,505,68.31,31.68,2
78926,GJ,GORJ,BERLEȘTI,1114,725,389,65.08,34.91,2
79077,GJ,GORJ,BOLBOȘI,1429,878,551,61.44,38.55,2
79157,GJ,GORJ,BORĂSCU,1623,951,672,58.59,41.40,2
79237,GJ,GORJ,BRĂNEȘTI,1238,834,404,67.36,32.63,2
79308,GJ,GORJ,BUMBEȘTI-JIU,4745,3063,1682,64.55,35.44,2
79362,GJ,GORJ,BUMBEȘTI-PIȚIC,1153,683,470,59.23,40.76,2
79406,GJ,GORJ,BUSTUCHIN,2137,1790,347,83.76,16.23,2
79736,GJ,GORJ,CÂLNIC,1562,639,923,40.90,59.09,1
79497,GJ,GORJ,CĂPRENI,1208,779,429,64.48,35.51,2
79585,GJ,GORJ,CĂTUNELE,1402,821,581,58.55,41.44,2
79656,GJ,GORJ,CIUPERCENI,1124,584,540,51.95,48.04,2
79834,GJ,GORJ,CRASNA,2748,1585,1163,57.67,42.32,2
79932,GJ,GORJ,CRUȘET,1631,1038,593,63.64,36.35,2
80043,GJ,GORJ,DĂNCIULEȘTI,1187,647,540,54.50,45.49,2
80123,GJ,GORJ,DĂNEȘTI,1933,1008,925,52.14,47.85,2
80249,GJ,GORJ,DRĂGOTEȘTI,1401,912,489,65.09,34.90,2
78016,GJ,GORJ,DRĂGUȚEȘTI,2852,1615,1237,56.62,43.37,2
80285,GJ,GORJ,FĂRCĂȘEȘTI,1983,1245,738,62.78,37.21,2
80365,GJ,GORJ,GLOGOVA,1284,816,468,63.55,36.44,2
80427,GJ,GORJ,GODINEȘTI,1233,817,416,66.26,33.73,2
80506,GJ,GORJ,HUREZANI,986,572,414,58.01,41.98,2
80560,GJ,GORJ,IONEȘTI,1352,1009,343,74.63,25.36,2
80613,GJ,GORJ,JUPÂNEȘTI,1048,706,342,67.36,32.63,2
80677,GJ,GORJ,LELEȘTI,1328,888,440,66.86,33.13,2
80711,GJ,GORJ,LICURICI,1044,638,406,61.11,38.88,2
80766,GJ,GORJ,LOGREȘTI,1548,1040,508,67.18,32.81,2
80846,GJ,GORJ,MĂTĂSARI,2664,1351,1313,50.71,49.28,2
78141,GJ,GORJ,MOTRU,10828,5945,4883,54.90,45.09,2
80908,GJ,GORJ,MUȘETEȘTI,1084,634,450,58.48,41.51,2
80980,GJ,GORJ,NEGOMIR,2033,1286,747,63.25,36.74,2
78258,GJ,GORJ,NOVACI,3357,1440,1917,42.89,57.10,1
81095,GJ,GORJ,PADEȘ,2260,1202,1058,53.18,46.81,2
81184,GJ,GORJ,PEȘTIȘANI,2325,1356,969,58.32,41.67,2
81264,GJ,GORJ,PLOPȘORU,3458,2334,1124,67.49,32.50,2
81380,GJ,GORJ,POLOVRAGI,1513,1040,473,68.73,31.26,2
81415,GJ,GORJ,PRIGORIA,1577,995,582,63.09,36.90,2
81497,GJ,GORJ,ROȘIA DE AMARADIA,1681,895,786,53.24,46.75,2
82895,GJ,GORJ,ROVINARI,5763,2363,3400,41.00,58.99,1
81576,GJ,GORJ,RUNCU,3379,2042,1337,60.43,39.56,2
81754,GJ,GORJ,SĂCELU,874,557,317,63.72,36.27,2
81656,GJ,GORJ,SAMARINEȘTI,1073,724,349,67.47,32.52,2
81816,GJ,GORJ,SĂULEȘTI,1287,942,345,73.19,26.80,2
81987,GJ,GORJ,SCHELA,983,629,354,63.98,36.01,2
81861,GJ,GORJ,SCOARȚA,2348,1472,876,62.69,37.30,2
82047,GJ,GORJ,SLIVILEȘTI,1831,1279,552,69.85,30.14,2
82136,GJ,GORJ,STĂNEȘTI,1303,739,564,56.71,43.28,2
82243,GJ,GORJ,STEJARI,1306,793,513,60.71,39.28,2
82314,GJ,GORJ,STOINA,1338,836,502,62.48,37.51,2
82680,GJ,GORJ,ȚÂNȚĂRENI,3073,2099,974,68.30,31.69,2
78329,GJ,GORJ,TÂRGU CĂRBUNEȘTI,4273,2347,1926,54.92,45.07,2
77812,GJ,GORJ,TÂRGU JIU,48733,26147,22586,53.65,46.34,2
82396,GJ,GORJ,TELEȘTI,1675,1157,518,69.07,30.92,2
78454,GJ,GORJ,ȚICLENI,2591,1384,1207,53.41,46.58,2
82430,GJ,GORJ,TISMANA,3894,2179,1715,55.95,44.04,2
82555,GJ,GORJ,TURBUREA,2428,1776,652,73.14,26.85,2
82617,GJ,GORJ,TURCENI,4427,2636,1791,59.54,40.45,2
78089,GJ,GORJ,TURCINEȘTI,1363,806,557,59.13,40.86,2
82733,GJ,GORJ,URDARI,1726,1106,620,64.07,35.92,2
82779,GJ,GORJ,VĂGIULEȘTI,1308,797,511,60.93,39.06,2
82831,GJ,GORJ,VLADIMIR,1653,1018,635,61.58,38.41,2
83785,HR,HARGHITA,ATID,828,323,505,39.00,60.99,1
83847,HR,HARGHITA,AVRĂMEȘTI,786,260,526,33.07,66.92,1
83428,HR,HARGHITA,BĂILE TUȘNAD,933,122,811,13.07,86.92,1
83464,HR,HARGHITA,BĂLAN,2185,1039,1146,47.55,52.44,1
83936,HR,HARGHITA,BILBOR,1402,707,695,50.42,49.57,2
83491,HR,HARGHITA,BORSEC,1433,174,1259,12.14,87.85,1
83151,HR,HARGHITA,BRĂDEȘTI,947,270,677,28.51,71.48,1
83963,HR,HARGHITA,CĂPÂLNIȚA,557,134,423,24.05,75.94,1
84102,HR,HARGHITA,CÂRȚA,1055,144,911,13.64,86.35,1
86461,HR,HARGHITA,CICEU,999,119,880,11.91,88.08,1
83981,HR,HARGHITA,CIUCSÂNGEORGIU,1531,365,1166,23.84,76.15,1
84086,HR,HARGHITA,CIUMANI,1489,174,1315,11.68,88.31,1
84148,HR,HARGHITA,CORBU,655,276,379,42.13,57.86,1
84175,HR,HARGHITA,CORUND,2068,660,1408,31.91,68.08,1
86446,HR,HARGHITA,COZMENI,786,307,479,39.05,60.94,1
83525,HR,HARGHITA,CRISTURU SECUIESC,3994,480,3514,12.01,87.98,1
84237,HR,HARGHITA,DĂNEȘTI,806,87,719,10.79,89.20,1
84380,HR,HARGHITA,DÂRJIU,380,69,311,18.15,81.84,1
84264,HR,HARGHITA,DEALU,1466,235,1231,16.03,83.96,1
84344,HR,HARGHITA,DITRĂU,1883,261,1622,13.86,86.13,1
83197,HR,HARGHITA,FELICENI,1418,225,1193,15.86,84.13,1
84415,HR,HARGHITA,FRUMOASA,1313,180,1133,13.70,86.29,1
84460,HR,HARGHITA,GĂLĂUȚAȘ,1069,399,670,37.32,62.67,1
83561,HR,HARGHITA,GHEORGHENI,7695,1041,6654,13.52,86.47,1
84558,HR,HARGHITA,JOSENI,2081,266,1815,12.78,87.21,1
84594,HR,HARGHITA,LĂZAREA,1080,127,953,11.75,88.24,1
86479,HR,HARGHITA,LELICENI,788,131,657,16.62,83.37,1
84629,HR,HARGHITA,LUETA,893,143,750,16.01,83.98,1
84656,HR,HARGHITA,LUNCA DE JOS,1926,375,1551,19.47,80.52,1
84754,HR,HARGHITA,LUNCA DE SUS,1200,188,1012,15.66,84.33,1
84825,HR,HARGHITA,LUPENI,1858,403,1455,21.68,78.31,1
86438,HR,HARGHITA,MĂDĂRAȘ,826,76,750,9.20,90.79,1
84923,HR,HARGHITA,MĂRTINIȘ,1314,349,965,26.56,73.43,1
85056,HR,HARGHITA,MEREȘTI,520,138,382,26.53,73.46,1
83320,HR,HARGHITA,MIERCUREA CIUC,19072,3260,15812,17.09,82.90,1
85074,HR,HARGHITA,MIHĂILENI,937,235,702,25.08,74.91,1
85127,HR,HARGHITA,MUGENI,1629,561,1068,34.43,65.56,1
85243,HR,HARGHITA,OCLAND,425,116,309,27.29,72.70,1
83133,HR,HARGHITA,ODORHEIU SECUIESC,15530,1680,13850,10.81,89.18,1
83375,HR,HARGHITA,PĂULENI-CIUC,779,90,689,11.55,88.44,1
85289,HR,HARGHITA,PLĂIEȘII DE JOS,985,285,700,28.93,71.06,1
86487,HR,HARGHITA,PORUMBENI,774,187,587,24.16,75.83,1
85341,HR,HARGHITA,PRAID,2231,571,1660,25.59,74.40,1
86495,HR,HARGHITA,RACU,569,96,473,16.87,83.12,1
85412,HR,HARGHITA,REMETEA,2382,382,2000,16.03,83.96,1
85467,HR,HARGHITA,SĂCEL,443,195,248,44.01,55.98,1
85680,HR,HARGHITA,SÂNCRĂIENI,961,142,819,14.77,85.22,1
85760,HR,HARGHITA,SÂNDOMINIC,1862,218,1644,11.70,88.29,1
85788,HR,HARGHITA,SÂNMARTIN,731,126,605,17.23,82.76,1
85840,HR,HARGHITA,SÂNSIMION,1244,175,1069,14.06,85.93,1
86519,HR,HARGHITA,SÂNTIMBRU,762,131,631,17.19,82.80,1
85528,HR,HARGHITA,SĂRMAȘ,2030,730,1300,35.96,64.03,1
86501,HR,HARGHITA,SATU MARE,644,218,426,33.85,66.14,1
85582,HR,HARGHITA,SECUIENI,974,238,736,24.43,75.56,1
85626,HR,HARGHITA,SICULENI,1063,216,847,20.31,79.68,1
85984,HR,HARGHITA,ȘIMONEȘTI,1768,650,1118,36.76,63.23,1
85877,HR,HARGHITA,SUBCETATE,887,356,531,40.13,59.86,1
85920,HR,HARGHITA,SUSENI,1775,154,1621,8.67,91.32,1
86453,HR,HARGHITA,TOMEȘTI,751,86,665,11.45,88.54,1
83632,HR,HARGHITA,TOPLIȚA,7349,2506,4843,34.09,65.90,1
86133,HR,HARGHITA,TULGHEȘ,1586,559,1027,35.24,64.75,1
86188,HR,HARGHITA,TUȘNAD,760,181,579,23.81,76.18,1
86222,HR,HARGHITA,ULIEȘ,430,121,309,28.13,71.86,1
86311,HR,HARGHITA,VĂRȘAG,639,83,556,12.98,87.01,1
83749,HR,HARGHITA,VLĂHIȚA,2587,323,2264,12.48,87.51,1
86339,HR,HARGHITA,VOȘLĂBENI,947,365,582,38.54,61.45,1
86366,HR,HARGHITA,ZETEA,2291,386,1905,16.84,83.15,1
87219,HD,HUNEDOARA,ANINOASA,2169,1530,639,70.53,29.46,2
88047,HD,HUNEDOARA,BĂCIA,1133,597,536,52.69,47.30,2
87745,HD,HUNEDOARA,BAIA DE CRIȘ,1556,716,840,46.01,53.98,1
88092,HD,HUNEDOARA,BĂIȚA,2149,1228,921,57.14,42.85,2
87843,HD,HUNEDOARA,BALȘA,651,227,424,34.86,65.13,1
87246,HD,HUNEDOARA,BĂNIȚA,707,343,364,48.51,51.48,1
87996,HD,HUNEDOARA,BARU,1648,532,1116,32.28,67.71,1
88216,HD,HUNEDOARA,BĂTRÂNA,102,26,76,25.49,74.50,1
88261,HD,HUNEDOARA,BERIU,1786,553,1233,30.96,69.03,1
88350,HD,HUNEDOARA,BLĂJENI,654,348,306,53.21,46.78,2
88449,HD,HUNEDOARA,BOȘOROD,1262,563,699,44.61,55.38,1
87291,HD,HUNEDOARA,BRAD,8499,4402,4097,51.79,48.20,2
88546,HD,HUNEDOARA,BRĂNIȘCA,1032,463,569,44.86,55.13,1
88644,HD,HUNEDOARA,BRETEA ROMÂNĂ,1900,848,1052,44.63,55.36,1
88788,HD,HUNEDOARA,BUCEȘ,1167,690,477,59.12,40.87,2
88868,HD,HUNEDOARA,BUCUREȘCI,1138,470,668,41.30,58.69,1
88920,HD,HUNEDOARA,BULZEȘTII DE SUS,199,136,63,68.34,31.65,2
89026,HD,HUNEDOARA,BUNILA,262,134,128,51.14,48.85,2
89080,HD,HUNEDOARA,BURJUC,509,277,232,54.42,45.57,2
87424,HD,HUNEDOARA,CĂLAN,6437,2539,3898,39.44,60.55,1
86749,HD,HUNEDOARA,CÂRJIȚI,513,169,344,32.94,67.05,1
89151,HD,HUNEDOARA,CERBĂL,365,161,204,44.10,55.89,1
89240,HD,HUNEDOARA,CERTEJU DE SUS,1891,789,1102,41.72,58.27,1
87362,HD,HUNEDOARA,CRIȘCIOR,2428,1085,1343,44.68,55.31,1
89348,HD,HUNEDOARA,DENSUȘ,1044,537,507,51.43,48.56,2
86687,HD,HUNEDOARA,DEVA,37869,15792,22077,41.70,58.29,1
89428,HD,HUNEDOARA,DOBRA,2118,1040,1078,49.10,50.89,1
91731,HD,HUNEDOARA,GENERAL BERTHELOT,564,249,315,44.14,55.85,1
89561,HD,HUNEDOARA,GEOAGIU,3714,1835,1879,49.40,50.59,1
86883,HD,HUNEDOARA,GHELARI,1125,645,480,57.33,42.66,2
89687,HD,HUNEDOARA,GURASADA,914,557,357,60.94,39.05,2
89801,HD,HUNEDOARA,HĂRĂU,1306,558,748,42.72,57.27,1
87576,HD,HUNEDOARA,HAȚEG,6157,2685,3472,43.60,56.39,1
86810,HD,HUNEDOARA,HUNEDOARA,34769,16765,18004,48.21,51.78,1
89856,HD,HUNEDOARA,ILIA,2581,945,1636,36.61,63.38,1
89954,HD,HUNEDOARA,LĂPUGIU DE JOS,814,376,438,46.19,53.80,1
90066,HD,HUNEDOARA,LELESE,292,211,81,72.26,27.73,2
90119,HD,HUNEDOARA,LUNCA CERNII DE JOS,554,200,354,36.10,63.89,1
90208,HD,HUNEDOARA,LUNCOIU DE JOS,1117,540,577,48.34,51.65,1
87059,HD,HUNEDOARA,LUPENI,12125,8435,3690,69.56,30.43,2
90262,HD,HUNEDOARA,MĂRTINEȘTI,684,309,375,45.17,54.82,1
87638,HD,HUNEDOARA,ORĂȘTIE,10958,4728,6230,43.14,56.85,1
90342,HD,HUNEDOARA,ORĂȘTIOARA DE SUS,1367,455,912,33.28,66.71,1
90431,HD,HUNEDOARA,PESTIȘU MIC,816,362,454,44.36,55.63,1
87077,HD,HUNEDOARA,PETRILA,11790,8107,3683,68.76,31.23,2
86990,HD,HUNEDOARA,PETROȘANI,20393,12693,7700,62.24,37.75,2
90538,HD,HUNEDOARA,PUI,2486,841,1645,33.82,66.17,1
90725,HD,HUNEDOARA,RĂCHITOVA,870,338,532,38.85,61.14,1
90663,HD,HUNEDOARA,RAPOLTU MARE,1108,428,680,38.62,61.37,1
90878,HD,HUNEDOARA,RÂU DE MORI,2024,577,1447,28.50,71.49,1
90805,HD,HUNEDOARA,RIBIȚA,941,487,454,51.75,48.24,2
90994,HD,HUNEDOARA,ROMOS,1591,400,1191,25.14,74.85,1
91116,HD,HUNEDOARA,SĂLAȘU DE SUS,1600,867,733,54.18,45.81,2
91232,HD,HUNEDOARA,SÂNTĂMĂRIA-ORLEA,1821,913,908,50.13,49.86,2
91054,HD,HUNEDOARA,SARMIZEGETUSA,980,372,608,37.95,62.04,1
87665,HD,HUNEDOARA,SIMERIA,7746,3579,4167,46.20,53.79,1
91330,HD,HUNEDOARA,ȘOIMUȘ,2849,1140,1709,40.01,59.98,1
86936,HD,HUNEDOARA,TELIUCU INFERIOR,1469,658,811,44.79,55.20,1
91447,HD,HUNEDOARA,TOMEȘTI,640,315,325,49.21,50.78,1
91535,HD,HUNEDOARA,TOPLIȚA,595,266,329,44.70,55.29,1
91624,HD,HUNEDOARA,TOTEȘTI,1242,799,443,64.33,35.66,2
91688,HD,HUNEDOARA,TURDAȘ,1139,479,660,42.05,57.94,1
87139,HD,HUNEDOARA,URICANI,4140,2710,1430,65.45,34.54,2
91937,HD,HUNEDOARA,VĂLIȘOARA,834,289,545,34.65,65.34,1
91795,HD,HUNEDOARA,VAȚA DE JOS,2150,990,1160,46.04,53.95,1
91982,HD,HUNEDOARA,VEȚEL,1746,818,928,46.84,53.15,1
92097,HD,HUNEDOARA,VORȚA,570,231,339,40.52,59.47,1
87175,HD,HUNEDOARA,VULCAN,12800,8926,3874,69.73,30.26,2
92177,HD,HUNEDOARA,ZAM,1186,517,669,43.59,56.40,1
100754,IL,IALOMIȚA,ADÂNCATA,1489,921,568,61.85,38.14,2
92783,IL,IALOMIȚA,ALBEȘTI,818,550,268,67.23,32.76,2
100852,IL,IALOMIȚA,ALEXENI,1019,586,433,57.50,42.49,2
92836,IL,IALOMIȚA,AMARA,3321,1980,1341,59.62,40.37,2
92872,IL,IALOMIȚA,ANDRĂȘEȘTI,1065,727,338,68.26,31.73,2
100870,IL,IALOMIȚA,ARMĂȘEȘTI,993,655,338,65.96,34.03,2
100923,IL,IALOMIȚA,AXINTELE,1216,868,348,71.38,28.61,2
92907,IL,IALOMIȚA,BALACIU,953,585,368,61.38,38.61,2
180064,IL,IALOMIȚA,BĂRBULEȘTI,945,644,301,68.14,31.85,2
101056,IL,IALOMIȚA,BĂRCĂNEȘTI,1450,905,545,62.41,37.58,2
179784,IL,IALOMIȚA,BORĂNEȘTI,1076,716,360,66.54,33.45,2
92989,IL,IALOMIȚA,BORDUȘANI,1800,1037,763,57.61,42.38,2
93021,IL,IALOMIȚA,BUCU,1150,507,643,44.08,55.91,1
179793,IL,IALOMIȚA,BUEȘTI,716,583,133,81.42,18.57,2
93067,IL,IALOMIȚA,CĂZĂNEȘTI,1437,989,448,68.82,31.17,2
100709,IL,IALOMIȚA,CIOCÂRLIA,378,251,127,66.40,33.59,2
93101,IL,IALOMIȚA,CIOCHINA,1627,945,682,58.08,41.91,2
93156,IL,IALOMIȚA,CIULNIȚA,1079,775,304,71.82,28.17,2
93209,IL,IALOMIȚA,COCORA,1130,818,312,72.38,27.61,2
179971,IL,IALOMIȚA,COLELIA,760,671,89,88.28,11.71,2
93236,IL,IALOMIȚA,COSÂMBEȘTI,1188,859,329,72.30,27.69,2
102240,IL,IALOMIȚA,COȘERENI,2291,1316,975,57.44,42.55,2
102641,IL,IALOMIȚA,DRĂGOEȘTI,695,448,247,64.46,35.53,2
102703,IL,IALOMIȚA,DRIDU,1811,983,828,54.27,45.72,2
93575,IL,IALOMIȚA,FĂCĂENI,2582,1257,1325,48.68,51.31,1
92701,IL,IALOMIȚA,FETEȘTI,15473,9464,6009,61.16,38.83,2
102749,IL,IALOMIȚA,FIERBINȚI-TÂRG,2563,1472,1091,57.43,42.56,2
103283,IL,IALOMIȚA,GÂRBOVI,1595,997,598,62.50,37.49,2
93600,IL,IALOMIȚA,GHEORGHE DOJA,1375,924,451,67.20,32.80,2
93628,IL,IALOMIȚA,GHEORGHE LAZĂR,1236,898,338,72.65,27.34,2
93646,IL,IALOMIȚA,GIURGENI,786,481,305,61.19,38.80,2
93717,IL,IALOMIȚA,GRINDU,976,741,235,75.92,24.07,2
93735,IL,IALOMIȚA,GRIVIȚA,1606,896,710,55.79,44.20,2
180046,IL,IALOMIȚA,GURA IALOMIȚEI,1169,804,365,68.77,31.22,2
103862,IL,IALOMIȚA,ION ROATĂ,1457,862,595,59.16,40.83,2
103960,IL,IALOMIȚA,JILAVELE,1769,1215,554,68.68,31.31,2
179800,IL,IALOMIȚA,MAIA,981,627,354,63.91,36.08,2
100736,IL,IALOMIȚA,MANASIA,2006,1103,903,54.98,45.01,2
179980,IL,IALOMIȚA,MĂRCULEȘTI,932,698,234,74.89,25.10,2
93995,IL,IALOMIȚA,MIHAIL KOGĂLNICEANU,1473,959,514,65.10,34.89,2
94045,IL,IALOMIȚA,MILOȘEȘTI,1147,779,368,67.91,32.08,2
179999,IL,IALOMIȚA,MOLDOVENI,829,617,212,74.42,25.57,2
94081,IL,IALOMIȚA,MOVILA,1057,698,359,66.03,33.96,2
104270,IL,IALOMIȚA,MOVILIȚA,1086,587,499,54.05,45.94,2
94107,IL,IALOMIȚA,MUNTENI-BUZĂU,1908,1272,636,66.66,33.33,2
179819,IL,IALOMIȚA,OGRADA,1318,899,419,68.20,31.79,2
94161,IL,IALOMIȚA,PERIEȚI,1486,879,607,59.15,40.84,2
180000,IL,IALOMIȚA,PLATONEȘTI,961,725,236,75.44,24.55,2
101243,IL,IALOMIȚA,RĂDULEȘTI,858,718,140,83.68,16.31,2
94269,IL,IALOMIȚA,REVIGA,1292,820,472,63.46,36.53,2
179828,IL,IALOMIȚA,ROȘIORI,983,552,431,56.15,43.84,2
94330,IL,IALOMIȚA,SĂLCIOARA,1017,651,366,64.01,35.98,2
180019,IL,IALOMIȚA,SĂRĂȚENI,639,334,305,52.26,47.73,2
94376,IL,IALOMIȚA,SĂVENI,1586,1203,383,75.85,24.14,2
94429,IL,IALOMIȚA,SCÂNTEIA,1905,1492,413,78.32,21.67,2
94456,IL,IALOMIȚA,SFÂNTU GHEORGHE,949,581,368,61.22,38.77,2
105026,IL,IALOMIȚA,SINEȘTI,1354,720,634,53.17,46.82,2
92658,IL,IALOMIȚA,SLOBOZIA,27091,14928,12163,55.10,44.89,2
94492,IL,IALOMIȚA,STELNICA,870,647,223,74.36,25.63,2
94535,IL,IALOMIȚA,SUDIȚI,928,610,318,65.73,34.26,2
92765,IL,IALOMIȚA,ȚĂNDĂREI,4736,3122,1614,65.92,34.07,2
179702,IL,IALOMIȚA,TRAIAN,1384,1056,328,76.30,23.69,2
100683,IL,IALOMIȚA,URZICENI,8651,4323,4328,49.97,50.02,1
94688,IL,IALOMIȚA,VALEA CIORII,995,755,240,75.87,24.12,2
105794,IL,IALOMIȚA,VALEA MĂCRIȘULUI,910,623,287,68.46,31.53,2
94795,IL,IALOMIȚA,VLĂDENI,1106,787,319,71.15,28.84,2
95612,IS,IAȘI,ALEXANDRU IOAN CUZA,1421,1117,304,78.60,21.39,2
95667,IS,IAȘI,ANDRIEȘENI,1825,966,859,52.93,47.06,2
95747,IS,IAȘI,ARONEANU,1893,667,1226,35.23,64.76,1
100273,IS,IAȘI,BALȘ,1336,917,419,68.63,31.36,2
95792,IS,IAȘI,BĂLȚAȚI,2522,1286,1236,50.99,49.00,2
95088,IS,IAȘI,BÂRNOVA,2842,1216,1626,42.78,57.21,1
95872,IS,IAȘI,BELCEȘTI,4182,2556,1626,61.11,38.88,2
95943,IS,IAȘI,BIVOLARI,1694,1076,618,63.51,36.48,2
96058,IS,IAȘI,BRĂEȘTI,1197,653,544,54.55,45.44,2
96110,IS,IAȘI,BUTEA,1232,598,634,48.53,51.46,1
96147,IS,IAȘI,CEPLENIȚA,1802,1045,757,57.99,42.00,2
100362,IS,IAȘI,CIOHORĂNI,818,620,198,75.79,24.20,2
96192,IS,IAȘI,CIORTEȘTI,1802,1287,515,71.42,28.57,2
96254,IS,IAȘI,CIUREA,6143,2671,3472,43.48,56.51,1
96334,IS,IAȘI,COARNELE CAPREI,1189,954,235,80.23,19.76,2
96370,IS,IAȘI,COMARNA,2380,1258,1122,52.85,47.14,2
100282,IS,IAȘI,COSTEȘTI,898,669,229,74.49,25.50,2
96423,IS,IAȘI,COSTULENI,2107,1419,688,67.34,32.65,2
96478,IS,IAȘI,COTNARI,2909,1689,1220,58.06,41.93,2
96593,IS,IAȘI,COZMEȘTI,1264,692,572,54.74,45.25,2
96637,IS,IAȘI,CRISTEȘTI,1830,1464,366,80.00,20.00,2
96664,IS,IAȘI,CUCUTENI,633,455,178,71.87,28.12,2
96717,IS,IAȘI,DAGÂȚA,2064,976,1088,47.28,52.71,1
96815,IS,IAȘI,DELENI,3920,2130,1790,54.33,45.66,2
96888,IS,IAȘI,DOBROVĂȚ,1086,728,358,67.03,32.96,2
96904,IS,IAȘI,DOLHEȘTI,1205,646,559,53.60,46.39,2
100308,IS,IAȘI,DRĂGUȘENI,580,388,192,66.89,33.10,2
96940,IS,IAȘI,DUMEȘTI,2052,1281,771,62.42,37.57,2
97009,IS,IAȘI,ERBICENI,2285,1297,988,56.76,43.23,2
100317,IS,IAȘI,FÂNTÂNELE,940,756,184,80.42,19.57,2
97063,IS,IAȘI,FOCURI,1370,920,450,67.15,32.84,2
97090,IS,IAȘI,GOLĂIEȘTI,1709,1139,570,66.64,33.35,2
97189,IS,IAȘI,GORBAN,1310,821,489,62.67,37.32,2
97241,IS,IAȘI,GRAJDURI,1272,770,502,60.53,39.46,2
97321,IS,IAȘI,GROPNIȚA,1416,1089,327,76.90,23.09,2
97394,IS,IAȘI,GROZEȘTI,759,545,214,71.80,28.19,2
97438,IS,IAȘI,HĂLĂUCEȘTI,2361,735,1626,31.13,68.86,1
95355,IS,IAȘI,HÂRLĂU,5183,3635,1548,70.13,29.86,2
100326,IS,IAȘI,HĂRMĂNEȘTI,1067,699,368,65.51,34.48,2
97465,IS,IAȘI,HELEȘTENI,1274,889,385,69.78,30.21,2
95159,IS,IAȘI,HOLBOCA,6376,2813,3563,44.11,55.88,1
97517,IS,IAȘI,HORLEȘTI,1169,675,494,57.74,42.25,2
95060,IS,IAȘI,IAȘI,186272,74204,112068,39.83,60.16,1
95499,IS,IAȘI,ION NECULCE,2394,1371,1023,57.26,42.73,2
97553,IS,IAȘI,IPATELE,972,766,206,78.80,21.19,2
97606,IS,IAȘI,LESPEZI,2401,1443,958,60.09,39.90,2
97679,IS,IAȘI,LEȚCANI,3400,1464,1936,43.05,56.94,1
97722,IS,IAȘI,LUNGANI,2370,1780,590,75.10,24.89,2
97777,IS,IAȘI,MĂDÂRJAC,696,492,204,70.68,29.31,2
97811,IS,IAȘI,MIRCEȘTI,1527,584,943,38.24,61.75,1
97875,IS,IAȘI,MIRONEASA,1581,652,929,41.23,58.76,1
97919,IS,IAȘI,MIROSLAVA,6633,2462,4171,37.11,62.88,1
98051,IS,IAȘI,MIROSLOVEȘTI,1728,1106,622,64.00,35.99,2
98113,IS,IAȘI,MOGOȘEȘTI,1952,1162,790,59.52,40.47,2
98168,IS,IAȘI,MOGOȘEȘTI-SIRET,1808,831,977,45.96,54.03,1
98202,IS,IAȘI,MOȘNA,816,635,181,77.81,22.18,2
98220,IS,IAȘI,MOȚCA,2296,1650,646,71.86,28.13,2
98257,IS,IAȘI,MOVILENI,1307,918,389,70.23,29.76,2
98300,IS,IAȘI,OȚELENI,1465,721,744,49.21,50.78,1
95391,IS,IAȘI,PAȘCANI,19022,10781,8241,56.67,43.32,2
98337,IS,IAȘI,PLUGARI,1542,975,567,63.22,36.77,2
98373,IS,IAȘI,PODU ILOAIEI,4142,1859,2283,44.88,55.11,1
98435,IS,IAȘI,POPEȘTI,1737,1168,569,67.24,32.75,2
98505,IS,IAȘI,POPRICANI,3757,2142,1615,57.01,42.98,2
98603,IS,IAȘI,PRISĂCANI,1559,902,657,57.85,42.14,2
98649,IS,IAȘI,PROBOTA,1624,960,664,59.11,40.88,2
100335,IS,IAȘI,RĂCHITENI,1165,527,638,45.23,54.76,1
98685,IS,IAȘI,RĂDUCĂNENI,3323,1900,1423,57.17,42.82,2
95239,IS,IAȘI,REDIU,2181,997,1184,45.71,54.28,1
98738,IS,IAȘI,ROMÂNEȘTI,892,568,324,63.67,36.32,2
100344,IS,IAȘI,ROȘCANI,644,485,159,75.31,24.68,2
98774,IS,IAȘI,RUGINOASA,2472,1627,845,65.81,34.18,2
98916,IS,IAȘI,SCÂNTEIA,1854,1034,820,55.77,44.22,2
99290,IS,IAȘI,ȘCHEIA,1340,834,506,62.23,37.76,2
98827,IS,IAȘI,SCHITU DUCA,2145,1422,723,66.29,33.70,2
98998,IS,IAȘI,SCOBINȚI,3163,2161,1002,68.32,31.67,2
99058,IS,IAȘI,SINEȘTI,1738,742,996,42.69,57.30,1
99370,IS,IAȘI,ȘIPOTE,1958,1383,575,70.63,29.36,2
99101,IS,IAȘI,SIREȚEL,1439,727,712,50.52,49.47,2
99165,IS,IAȘI,STOLNICENI-PRĂJESCU,2343,1532,811,65.38,34.61,2
99209,IS,IAȘI,STRUNGA,1718,1086,632,63.21,36.78,2
99441,IS,IAȘI,TANSA,1428,825,603,57.77,42.22,2
95471,IS,IAȘI,TÂRGU FRUMOS,5847,3084,2763,52.74,47.25,2
99478,IS,IAȘI,TĂTĂRUȘI,2752,2156,596,78.34,21.65,2
99673,IS,IAȘI,ȚIBANA,2519,1763,756,69.98,30.01,2
99780,IS,IAȘI,ȚIBĂNEȘTI,3240,1778,1462,54.87,45.12,2
99879,IS,IAȘI,ȚIGĂNĂȘI,2036,1457,579,71.56,28.43,2
99539,IS,IAȘI,TODIREȘTI,1745,887,858,50.83,49.16,2
95293,IS,IAȘI,TOMEȘTI,5858,2592,3266,44.24,55.75,1
99600,IS,IAȘI,TRIFEȘTI,1732,802,930,46.30,53.69,1
99922,IS,IAȘI,ȚUȚORA,1160,637,523,54.91,45.08,2
96003,IS,IAȘI,UNGHENI,1832,957,875,52.23,47.76,2
100353,IS,IAȘI,VALEA LUPULUI,3193,1303,1890,40.80,59.19,1
99968,IS,IAȘI,VALEA SEACĂ,2673,1990,683,74.44,25.55,2
100086,IS,IAȘI,VÂNĂTORI,2088,1357,731,64.99,35.00,2
100004,IS,IAȘI,VICTORIA,1755,1055,700,60.11,39.88,2
100148,IS,IAȘI,VLĂDENI,1820,1103,717,60.60,39.39,2
100219,IS,IAȘI,VOINEȘTI,2609,1751,858,67.11,32.88,2
102543,IF,ILFOV,1 DECEMBRIE,4479,2420,2059,54.02,45.97,2
100834,IF,ILFOV,AFUMAȚI,4813,1939,2874,40.28,59.71,1
100969,IF,ILFOV,BALOTEȘTI,5172,2332,2840,45.08,54.91,1
101145,IF,ILFOV,BERCENI,4503,2353,2150,52.25,47.74,2
179221,IF,ILFOV,BRAGADIRU,10901,4240,6661,38.89,61.10,1
101298,IF,ILFOV,BRĂNEȘTI,5470,2815,2655,51.46,48.53,2
100576,IF,ILFOV,BUFTEA,11631,5391,6240,46.35,53.64,1
101742,IF,ILFOV,CERNICA,5287,3374,1913,63.81,36.18,2
179249,IF,ILFOV,CHIAJNA,11033,5145,5888,46.63,53.36,1
179285,IF,ILFOV,CHITILA,8244,3913,4331,47.46,52.53,1
101902,IF,ILFOV,CIOLPANI,3198,1230,1968,38.46,61.53,1
101957,IF,ILFOV,CIOROGÂRLA,2985,1469,1516,49.21,50.78,1
102035,IF,ILFOV,CLINCENI,4124,1769,2355,42.89,57.10,1
179588,IF,ILFOV,COPĂCENI,1908,1264,644,66.24,33.75,2
102160,IF,ILFOV,CORBEANCA,5284,2157,3127,40.82,59.17,1
102213,IF,ILFOV,CORNETU,3165,1455,1710,45.97,54.02,1
102525,IF,ILFOV,DĂRĂȘTI-ILFOV,1636,1000,636,61.12,38.87,2
102473,IF,ILFOV,DASCĂLU,1661,857,804,51.59,48.40,2
179310,IF,ILFOV,DOBROEȘTI,5491,2868,2623,52.23,47.76,2
102570,IF,ILFOV,DOMNEȘTI,5807,2204,3603,37.95,62.04,1
102605,IF,ILFOV,DRAGOMIREȘTI-VALE,3166,1411,1755,44.56,55.43,1
103130,IF,ILFOV,GĂNEASA,2824,1450,1374,51.34,48.65,2
179347,IF,ILFOV,GLINA,3972,2163,1809,54.45,45.54,2
103443,IF,ILFOV,GRĂDIȘTEA,1785,1024,761,57.36,42.63,2
103513,IF,ILFOV,GRUIU,4299,1956,2343,45.49,54.50,1
179383,IF,ILFOV,JILAVA,6951,4533,2418,65.21,34.78,2
179409,IF,ILFOV,MĂGURELE,7118,3261,3857,45.81,54.18,1
104243,IF,ILFOV,MOARA VLĂSIEI,3707,1240,2467,33.45,66.54,1
179463,IF,ILFOV,MOGOȘOAIA,4800,1469,3331,30.60,69.39,1
104421,IF,ILFOV,NUCI,2029,1479,550,72.89,27.10,2
179481,IF,ILFOV,OTOPENI,10559,3679,6880,34.84,65.15,1
179515,IF,ILFOV,PANTELIMON,13636,7140,6496,52.36,47.63,2
104546,IF,ILFOV,PERIȘ,4251,1865,2386,43.87,56.12,1
104582,IF,ILFOV,PETRĂCHIOAIA,2168,940,1228,43.35,56.64,1
179533,IF,ILFOV,POPEȘTI LEORDENI,18203,8578,9625,47.12,52.87,1
105160,IF,ILFOV,SNAGOV,5548,2706,2842,48.77,51.22,1
105419,IF,ILFOV,ȘTEFĂNEȘTII DE JOS,4492,2301,2191,51.22,48.77,2
105570,IF,ILFOV,TUNARI,3611,1721,1890,47.65,52.34,1
105936,IF,ILFOV,VIDRA,4286,2108,2178,49.18,50.81,1
179551,IF,ILFOV,VOLUNTARI,25606,13707,11899,53.53,46.46,2
107001,MM,MARAMUREȘ,ARDUSAT,1110,444,666,40.00,60.00,1
107047,MM,MARAMUREȘ,ARINIȘ,680,339,341,49.85,50.14,1
107083,MM,MARAMUREȘ,ASUAJU DE SUS,799,531,268,66.45,33.54,2
106318,MM,MARAMUREȘ,BAIA MARE,68954,22501,46453,32.63,67.36,1
106684,MM,MARAMUREȘ,BAIA SPRIE,7775,2587,5188,33.27,66.72,1
107118,MM,MARAMUREȘ,BĂIȚA DE SUB CODRU,917,411,506,44.82,55.17,1
107154,MM,MARAMUREȘ,BĂIUȚ,1040,450,590,43.26,56.73,1
107314,MM,MARAMUREȘ,BÂRSANA,1941,696,1245,35.85,64.14,1
107190,MM,MARAMUREȘ,BĂSEȘTI,675,331,344,49.03,50.96,1
107234,MM,MARAMUREȘ,BICAZ,623,390,233,62.60,37.39,2
107270,MM,MARAMUREȘ,BISTRA,1633,620,1013,37.96,62.03,1
107350,MM,MARAMUREȘ,BOCICOIU MARE,1878,979,899,52.12,47.87,2
107403,MM,MARAMUREȘ,BOGDAN VODĂ,1362,735,627,53.96,46.03,2
107430,MM,MARAMUREȘ,BOIU MARE,746,462,284,61.93,38.06,2
106746,MM,MARAMUREȘ,BORȘA,9828,3422,6406,34.81,65.18,1
107485,MM,MARAMUREȘ,BOTIZA,1283,840,443,65.47,34.52,2
107519,MM,MARAMUREȘ,BUDEȘTI,1549,739,810,47.70,52.29,1
107546,MM,MARAMUREȘ,CĂLINEȘTI,1436,426,1010,29.66,70.33,1
107715,MM,MARAMUREȘ,CÂMPULUNG LA TISA,1768,683,1085,38.63,61.36,1
106782,MM,MARAMUREȘ,CAVNIC,2125,828,1297,38.96,61.03,1
107582,MM,MARAMUREȘ,CERNEȘTI,1782,953,829,53.47,46.52,2
107662,MM,MARAMUREȘ,CICÂRLĂU,786,204,582,25.95,74.04,1
179837,MM,MARAMUREȘ,COAȘ,696,284,412,40.80,59.19,1
179846,MM,MARAMUREȘ,COLTĂU,981,285,696,29.05,70.94,1
107733,MM,MARAMUREȘ,COPALNIC-MĂNĂȘTUR,2713,1051,1662,38.73,61.26,1
107868,MM,MARAMUREȘ,COROIENI,1211,522,689,43.10,56.89,1
107920,MM,MARAMUREȘ,CUPȘENI,1602,656,946,40.94,59.05,1
107975,MM,MARAMUREȘ,DESEȘTI,1243,302,941,24.29,75.70,1
108017,MM,MARAMUREȘ,DRAGOMIREȘTI,1394,583,811,41.82,58.17,1
108035,MM,MARAMUREȘ,DUMBRĂVIȚA,2297,816,1481,35.52,64.47,1
108106,MM,MARAMUREȘ,FĂRCAȘA,1802,747,1055,41.45,58.54,1
179855,MM,MARAMUREȘ,GÂRDANI,686,271,415,39.50,60.49,1
108151,MM,MARAMUREȘ,GIULEȘTI,1351,573,778,42.41,57.58,1
106363,MM,MARAMUREȘ,GROȘI,1397,374,1023,26.77,73.22,1
179622,MM,MARAMUREȘ,GROȘII ȚIBLEȘULUI,1130,490,640,43.36,56.63,1
108204,MM,MARAMUREȘ,IEUD,1525,685,840,44.91,55.08,1
108222,MM,MARAMUREȘ,LĂPUȘ,1679,740,939,44.07,55.92,1
108240,MM,MARAMUREȘ,LEORDINA,1003,387,616,38.58,61.41,1
108268,MM,MARAMUREȘ,MIREȘU MARE,2347,959,1388,40.86,59.13,1
108348,MM,MARAMUREȘ,MOISEI,4055,1666,2389,41.08,58.91,1
108366,MM,MARAMUREȘ,OARȚA DE JOS,653,303,350,46.40,53.59,1
108400,MM,MARAMUREȘ,OCNA ȘUGATAG,1987,505,1482,25.41,74.58,1
179864,MM,MARAMUREȘ,ONCEȘTI,747,298,449,39.89,60.10,1
108455,MM,MARAMUREȘ,PETROVA,1176,649,527,55.18,44.81,2
108473,MM,MARAMUREȘ,POIENILE DE SUB MUNTE,3854,2677,1177,69.46,30.53,2
179604,MM,MARAMUREȘ,POIENILE IZEI,510,272,238,53.33,46.66,2
106407,MM,MARAMUREȘ,RECEA,3701,1581,2120,42.71,57.28,1
108491,MM,MARAMUREȘ,REMETEA CHIOARULUI,1245,458,787,36.78,63.21,1
108552,MM,MARAMUREȘ,REMEȚI,1175,574,601,48.85,51.14,1
108598,MM,MARAMUREȘ,REPEDEA,1882,857,1025,45.53,54.46,1
108614,MM,MARAMUREȘ,RONA DE JOS,866,468,398,54.04,45.95,2
108632,MM,MARAMUREȘ,RONA DE SUS,1519,685,834,45.09,54.90,1
108669,MM,MARAMUREȘ,ROZAVLEA,1246,593,653,47.59,52.40,1
108696,MM,MARAMUREȘ,RUSCOVA,1862,546,1316,29.32,70.67,1
108794,MM,MARAMUREȘ,SĂCĂLĂȘENI,1165,535,630,45.92,54.07,1
108874,MM,MARAMUREȘ,SĂCEL,1513,789,724,52.14,47.85,2
108892,MM,MARAMUREȘ,SĂLIȘTEA DE SUS,2227,957,1270,42.97,57.02,1
108918,MM,MARAMUREȘ,SĂLSIG,897,347,550,38.68,61.31,1
108945,MM,MARAMUREȘ,SĂPÂNȚA,1540,655,885,42.53,57.46,1
106620,MM,MARAMUREȘ,SARASĂU,1110,455,655,40.99,59.00,1
108712,MM,MARAMUREȘ,SATULUNG,3000,1649,1351,54.96,45.03,2
108963,MM,MARAMUREȘ,SEINI,4546,1822,2724,40.07,59.92,1
179613,MM,MARAMUREȘ,ȘIEU,1013,613,400,60.51,39.48,2
106559,MM,MARAMUREȘ,SIGHETU MARMAȚIEI,18943,7198,11745,37.99,62.00,1
109096,MM,MARAMUREȘ,ȘISEȘTI,2773,994,1779,35.84,64.15,1
109176,MM,MARAMUREȘ,ȘOMCUTA MARE,4028,2258,1770,56.05,43.94,2
109005,MM,MARAMUREȘ,STRÂMTURA,1686,664,1022,39.38,60.61,1
109041,MM,MARAMUREȘ,SUCIU DE SUS,2140,1426,714,66.63,33.36,2
106817,MM,MARAMUREȘ,TÂRGU LĂPUȘ,5807,2211,3596,38.07,61.92,1
106461,MM,MARAMUREȘ,TĂUȚII-MĂGHERĂUȘ,4480,1781,2699,39.75,60.24,1
109265,MM,MARAMUREȘ,ULMENI,4033,2549,1484,63.20,36.79,2
106648,MM,MARAMUREȘ,VADU IZEI,1456,763,693,52.40,47.59,2
109354,MM,MARAMUREȘ,VALEA CHIOARULUI,1191,703,488,59.02,40.97,2
109425,MM,MARAMUREȘ,VIMA MICĂ,745,320,425,42.95,57.04,1
109504,MM,MARAMUREȘ,VIȘEU DE JOS,2361,918,1443,38.88,61.11,1
106979,MM,MARAMUREȘ,VIȘEU DE SUS,7368,2816,4552,38.21,61.78,1
110571,MH,MEHEDINȚI,BÂCLEȘ,1464,1204,260,82.24,17.75,2
109924,MH,MEHEDINȚI,BAIA DE ARAMĂ,3451,2086,1365,60.44,39.55,2
110296,MH,MEHEDINȚI,BALA,2254,1402,852,62.20,37.79,2
110535,MH,MEHEDINȚI,BĂLĂCIȚA,1605,1236,369,77.00,22.99,2
110456,MH,MEHEDINȚI,BALTA,817,569,248,69.64,30.35,2
110688,MH,MEHEDINȚI,BÂLVĂNEȘTI,635,472,163,74.33,25.66,2
114060,MH,MEHEDINȚI,BRANIȘTEA,1400,1135,265,81.07,18.92,2
110740,MH,MEHEDINȚI,BREZNIȚA-MOTRU,965,654,311,67.77,32.22,2
110820,MH,MEHEDINȚI,BREZNIȚA-OCOL,2042,1155,887,56.56,43.43,2
110875,MH,MEHEDINȚI,BROȘTENI,1721,1228,493,71.35,28.64,2
110946,MH,MEHEDINȚI,BURILA MARE,1412,836,576,59.20,40.79,2
111006,MH,MEHEDINȚI,BUTOIEȘTI,1796,1122,674,62.47,37.52,2
111097,MH,MEHEDINȚI,CĂZĂNEȘTI,1357,812,545,59.83,40.16,2
111220,MH,MEHEDINȚI,CIREȘU,352,250,102,71.02,28.97,2
111275,MH,MEHEDINȚI,CORCOVA,2806,1846,960,65.78,34.21,2
111417,MH,MEHEDINȚI,CORLĂȚEL,880,708,172,80.45,19.54,2
111444,MH,MEHEDINȚI,CUJMIR,1898,1269,629,66.85,33.14,2
111550,MH,MEHEDINȚI,DÂRVARI,1301,990,311,76.09,23.90,2
111480,MH,MEHEDINȚI,DEVESEL,2013,1037,976,51.51,48.48,2
109773,MH,MEHEDINȚI,DROBETA-TURNU SEVERIN,50884,27917,22967,54.86,45.13,2
112904,MH,MEHEDINȚI,DUBOVA,595,325,270,54.62,45.37,2
111587,MH,MEHEDINȚI,DUMBRAVA,874,517,357,59.15,40.84,2
112245,MH,MEHEDINȚI,EȘELNIȚA,1562,914,648,58.51,41.48,2
111685,MH,MEHEDINȚI,FLOREȘTI,1574,1167,407,74.14,25.85,2
111783,MH,MEHEDINȚI,GÂRLA MARE,1373,941,432,68.53,31.46,2
111818,MH,MEHEDINȚI,GODEANU,490,354,136,72.24,27.75,2
111863,MH,MEHEDINȚI,GOGOȘU,2661,1992,669,74.85,25.14,2
111916,MH,MEHEDINȚI,GRECI,824,576,248,69.90,30.09,2
111989,MH,MEHEDINȚI,GROZEȘTI,875,583,292,66.62,33.37,2
112030,MH,MEHEDINȚI,GRUIA,1385,1031,354,74.44,25.55,2
112076,MH,MEHEDINȚI,HINOVA,1417,945,472,66.69,33.30,2
112129,MH,MEHEDINȚI,HUSNICIOARA,783,563,220,71.90,28.09,2
112263,MH,MEHEDINȚI,ILOVĂȚ,639,452,187,70.73,29.26,2
112334,MH,MEHEDINȚI,ILOVIȚA,840,563,277,67.02,32.97,2
112370,MH,MEHEDINȚI,ISVERNA,1046,695,351,66.44,33.55,2
112469,MH,MEHEDINȚI,IZVORU BÂRZII,1649,871,778,52.81,47.18,2
112548,MH,MEHEDINȚI,JIANA,2928,2487,441,84.93,15.06,2
112600,MH,MEHEDINȚI,LIVEZILE,1112,834,278,75.00,25.00,2
112664,MH,MEHEDINȚI,MALOVĂȚ,1760,1157,603,65.73,34.26,2
110027,MH,MEHEDINȚI,OBÂRȘIA-CLOȘANI,557,303,254,54.39,45.60,2
112744,MH,MEHEDINȚI,OBÂRȘIA DE CÂMP,1267,937,330,73.95,26.04,2
112771,MH,MEHEDINȚI,OPRIȘOR,1460,902,558,61.78,38.21,2
110063,MH,MEHEDINȚI,ORȘOVA,5833,3116,2717,53.42,46.57,2
112806,MH,MEHEDINȚI,PĂDINA,968,756,212,78.09,21.90,2
112879,MH,MEHEDINȚI,PĂTULELE,2390,1675,715,70.08,29.91,2
112959,MH,MEHEDINȚI,PODENI,588,412,176,70.06,29.93,2
112995,MH,MEHEDINȚI,PONOARELE,1443,974,469,67.49,32.50,2
113153,MH,MEHEDINȚI,POROINA MARE,742,577,165,77.76,22.23,2
113206,MH,MEHEDINȚI,PRISTOL,917,572,345,62.37,37.62,2
113233,MH,MEHEDINȚI,PRUNIȘOR,1278,908,370,71.04,28.95,2
113395,MH,MEHEDINȚI,PUNGHINA,1247,967,280,77.54,22.45,2
113466,MH,MEHEDINȚI,ROGOVA,1024,694,330,67.77,32.22,2
113493,MH,MEHEDINȚI,SALCIA,1635,1059,576,64.77,35.22,2
109826,MH,MEHEDINȚI,ȘIMIAN,5278,3608,1670,68.35,31.64,2
113625,MH,MEHEDINȚI,ȘIȘEȘTI,1684,1246,438,73.99,26.00,2
113698,MH,MEHEDINȚI,ȘOVARNA,778,608,170,78.14,21.85,2
113518,MH,MEHEDINȚI,STÂNGĂCEAUA,816,582,234,71.32,28.67,2
110116,MH,MEHEDINȚI,STREHAIA,5311,3289,2022,61.92,38.07,2
113607,MH,MEHEDINȚI,SVINIȚA,650,437,213,67.23,32.76,2
113732,MH,MEHEDINȚI,TÂMNA,1420,923,497,65.00,35.00,2
113849,MH,MEHEDINȚI,VÂNĂTORI,1166,790,376,67.75,32.24,2
110232,MH,MEHEDINȚI,VÂNJU MARE,3331,2128,1203,63.88,36.11,2
113894,MH,MEHEDINȚI,VÂNJULEȚ,1342,1245,97,92.77,7.22,2
113929,MH,MEHEDINȚI,VLĂDAIA,1289,953,336,73.93,26.06,2
113974,MH,MEHEDINȚI,VOLOIAC,1046,783,263,74.85,25.14,2
114079,MH,MEHEDINȚI,VRATA,908,709,199,78.08,21.91,2
114970,MS,MUREȘ,ACĂȚARI,1905,579,1326,30.39,69.60,1
115076,MS,MUREȘ,ADĂMUȘ,2296,753,1543,32.79,67.20,1
114603,MS,MUREȘ,ALBEȘTI,2877,1006,1871,34.96,65.03,1
115147,MS,MUREȘ,ALUNIȘ,1531,307,1224,20.05,79.94,1
115183,MS,MUREȘ,APOLD,1156,408,748,35.29,64.70,1
115236,MS,MUREȘ,AȚINTIȘ,794,225,569,28.33,71.66,1
115575,MS,MUREȘ,BĂGACIU,1203,324,879,26.93,73.06,1
115307,MS,MUREȘ,BAHNEA,1509,460,1049,30.48,69.51,1
115600,MS,MUREȘ,BĂLA,451,222,229,49.22,50.77,1
115637,MS,MUREȘ,BĂLĂUȘERI,1891,304,1587,16.07,83.92,1
115389,MS,MUREȘ,BAND,2506,723,1783,28.85,71.14,1
115520,MS,MUREȘ,BATOȘ,1926,625,1301,32.45,67.54,1
115708,MS,MUREȘ,BEICA DE JOS,1071,533,538,49.76,50.23,1
120511,MS,MUREȘ,BERENI,435,135,300,31.03,68.96,1
115771,MS,MUREȘ,BICHIȘ,425,99,326,23.29,76.70,1
115824,MS,MUREȘ,BOGATA,868,260,608,29.95,70.04,1
115897,MS,MUREȘ,BRÂNCOVENEȘTI,1783,414,1369,23.21,76.78,1
115851,MS,MUREȘ,BREAZA,1224,234,990,19.11,80.88,1
115959,MS,MUREȘ,CEUAȘU DE CÂMPIE,2657,815,1842,30.67,69.32,1
116046,MS,MUREȘ,CHEȚANI,1322,438,884,33.13,66.86,1
120478,MS,MUREȘ,CHIBED,425,89,336,20.94,79.05,1
116126,MS,MUREȘ,CHIHERU DE JOS,874,406,468,46.45,53.54,1
116171,MS,MUREȘ,COROISÂNMĂRTIN,698,276,422,39.54,60.45,1
120487,MS,MUREȘ,CORUNCA,1327,283,1044,21.32,78.67,1
116224,MS,MUREȘ,COZMA,317,65,252,20.50,79.49,1
116288,MS,MUREȘ,CRĂCIUNEȘTI,1326,384,942,28.95,71.04,1
116340,MS,MUREȘ,CRĂIEȘTI,481,136,345,28.27,71.72,1
114355,MS,MUREȘ,CRISTEȘTI,2748,758,1990,27.58,72.41,1
116395,MS,MUREȘ,CUCERDEA,749,321,428,42.85,57.14,1
116439,MS,MUREȘ,CUCI,1058,483,575,45.65,54.34,1
116493,MS,MUREȘ,DANEȘ,2492,593,1899,23.79,76.20,1
116545,MS,MUREȘ,DEDA,2430,1294,1136,53.25,46.74,2
116590,MS,MUREȘ,EREMITU,1204,245,959,20.34,79.65,1
116652,MS,MUREȘ,ERNEI,1902,468,1434,24.60,75.39,1
116796,MS,MUREȘ,FÂNTÂNELE,1750,241,1509,13.77,86.22,1
116723,MS,MUREȘ,FĂRĂGĂU,908,600,308,66.07,33.92,2
116867,MS,MUREȘ,GĂLEȘTI,757,192,565,25.36,74.63,1
116938,MS,MUREȘ,GĂNEȘTI,1661,257,1404,15.47,84.52,1
116983,MS,MUREȘ,GHEORGHE DOJA,1163,188,975,16.16,83.83,1
117042,MS,MUREȘ,GHINDARI,881,236,645,26.78,73.21,1
117113,MS,MUREȘ,GLODENI,1257,451,806,35.87,64.12,1
117177,MS,MUREȘ,GORNEȘTI,2363,626,1737,26.49,73.50,1
117275,MS,MUREȘ,GREBENIȘU DE CÂMPIE,828,369,459,44.56,55.43,1
117319,MS,MUREȘ,GURGHIU,3010,765,2245,25.41,74.58,1
117426,MS,MUREȘ,HODAC,2571,869,1702,33.80,66.19,1
117505,MS,MUREȘ,HODOȘA,506,117,389,23.12,76.87,1
117550,MS,MUREȘ,IBĂNEȘTI,2461,1146,1315,46.56,53.43,1
117667,MS,MUREȘ,ICLĂNZEL,1012,422,590,41.69,58.30,1
117783,MS,MUREȘ,IDECIU DE JOS,1073,469,604,43.70,56.29,1
117827,MS,MUREȘ,IERNUT,4923,1597,3326,32.43,67.56,1
117925,MS,MUREȘ,LIVEZENI,1391,326,1065,23.43,76.56,1
114710,MS,MUREȘ,LUDUȘ,9092,3662,5430,40.27,59.72,1
117998,MS,MUREȘ,LUNCA,1433,603,830,42.07,57.92,1
118058,MS,MUREȘ,LUNCA BRADULUI,888,316,572,35.58,64.41,1
120502,MS,MUREȘ,MĂDĂRAȘ,476,138,338,28.99,71.00,1
118094,MS,MUREȘ,MĂGHERANI,398,102,296,25.62,74.37,1
118209,MS,MUREȘ,MICA,1793,587,1206,32.73,67.26,1
118281,MS,MUREȘ,MIERCUREA NIRAJULUI,1822,384,1438,21.07,78.92,1
118370,MS,MUREȘ,MIHEȘU DE CÂMPIE,1135,572,563,50.39,49.60,2
118469,MS,MUREȘ,NADEȘ,1073,180,893,16.77,83.22,1
118511,MS,MUREȘ,NEAUA,492,118,374,23.98,76.01,1
118575,MS,MUREȘ,OGRA,1123,359,764,31.96,68.03,1
118691,MS,MUREȘ,PĂNET,2303,433,1870,18.80,81.19,1
118637,MS,MUREȘ,PAPIU ILARIAN,383,81,302,21.14,78.85,1
118753,MS,MUREȘ,PĂSĂRENI,717,147,570,20.50,79.49,1
118799,MS,MUREȘ,PETELEA,1087,495,592,45.53,54.46,1
118824,MS,MUREȘ,POGĂCEAUA,950,303,647,31.89,68.10,1
118995,MS,MUREȘ,RÂCIU,1841,597,1244,32.42,67.57,1
118931,MS,MUREȘ,RĂSTOLIȚA,1050,376,674,35.80,64.19,1
114809,MS,MUREȘ,REGHIN,19472,6179,13293,31.73,68.26,1
119153,MS,MUREȘ,RUȘII-MUNȚI,1177,635,542,53.95,46.04,2
114382,MS,MUREȘ,SÂNCRAIU DE MUREȘ,4095,1253,2842,30.59,69.40,1
114417,MS,MUREȘ,SÂNGEORGIU DE MUREȘ,4498,1152,3346,25.61,74.38,1
119331,MS,MUREȘ,SÂNGEORGIU DE PĂDURE,1646,420,1226,25.51,74.48,1
119386,MS,MUREȘ,SÂNGER,1090,341,749,31.28,68.71,1
119466,MS,MUREȘ,SÂNPAUL,2055,1058,997,51.48,48.51,2
119527,MS,MUREȘ,SÂNPETRU DE CÂMPIE,1372,673,699,49.05,50.94,1
114453,MS,MUREȘ,SÂNTANA DE MUREȘ,2906,783,2123,26.94,73.05,1
120496,MS,MUREȘ,SĂRĂȚENI,446,157,289,35.20,64.79,1
119242,MS,MUREȘ,SARMAȘU,3481,1281,2200,36.79,63.20,1
119206,MS,MUREȘ,SASCHIZ,972,420,552,43.20,56.79,1
119750,MS,MUREȘ,ȘĂULIA,985,531,454,53.90,46.09,2
114514,MS,MUREȘ,SIGHIȘOARA,16157,4471,11686,27.67,72.32,1
119803,MS,MUREȘ,ȘINCAI,707,266,441,37.62,62.37,1
119590,MS,MUREȘ,SOLOVĂSTRU,1461,594,867,40.65,59.34,1
114854,MS,MUREȘ,SOVATA,4369,722,3647,16.52,83.47,1
119625,MS,MUREȘ,STÂNCENI,771,301,470,39.04,60.95,1
119661,MS,MUREȘ,SUPLAC,1066,355,711,33.30,66.69,1
119723,MS,MUREȘ,SUSENI,1174,347,827,29.55,70.44,1
114319,MS,MUREȘ,TÂRGU MUREȘ,77567,22548,55019,29.06,70.93,1
114925,MS,MUREȘ,TÂRNĂVENI,11827,4432,7395,37.47,62.52,1
119858,MS,MUREȘ,TĂURENI,573,382,191,66.66,33.33,2
119894,MS,MUREȘ,UNGHENI,3960,1526,2434,38.53,61.46,1
119974,MS,MUREȘ,VALEA LARGĂ,1131,372,759,32.89,67.10,1
120254,MS,MUREȘ,VÂNĂTORI,1785,824,961,46.16,53.83,1
120076,MS,MUREȘ,VĂRGATA,669,136,533,20.32,79.67,1
120138,MS,MUREȘ,VĂTAVA,1133,444,689,39.18,60.81,1
120174,MS,MUREȘ,VEȚCA,298,62,236,20.80,79.19,1
120218,MS,MUREȘ,VIIȘOARA,724,184,540,25.41,74.58,1
120316,MS,MUREȘ,VOIVODENI,819,342,477,41.75,58.24,1
120343,MS,MUREȘ,ZAGĂR,461,110,351,23.86,76.13,1
120370,MS,MUREȘ,ZAU DE CÂMPIE,1422,493,929,34.66,65.33,1
121108,NT,NEAMȚ,AGAPIA,2098,1316,782,62.72,37.27,2
124938,NT,NEAMȚ,ALEXANDRU CEL BUN,2905,1233,1672,42.44,57.55,1
121153,NT,NEAMȚ,BAHNA,1630,1076,554,66.01,33.98,2
121242,NT,NEAMȚ,BĂLȚĂTEȘTI,2139,1340,799,62.64,37.35,2
121386,NT,NEAMȚ,BÂRA,894,487,407,54.47,45.52,2
121466,NT,NEAMȚ,BÂRGĂUANI,1978,1318,660,66.63,33.36,2
120968,NT,NEAMȚ,BICAZ,3868,2049,1819,52.97,47.02,2
121297,NT,NEAMȚ,BICAZ-CHEI,2241,1088,1153,48.54,51.45,1
121340,NT,NEAMȚ,BICAZU ARDELEAN,1781,560,1221,31.44,68.55,1
121607,NT,NEAMȚ,BODEȘTI,2229,1361,868,61.05,38.94,2
125178,NT,NEAMȚ,BOGHICEA,1120,716,404,63.92,36.07,2
121652,NT,NEAMȚ,BORCA,3145,2044,1101,64.99,35.00,2
121732,NT,NEAMȚ,BORLEȘTI,3580,1734,1846,48.43,51.56,1
121796,NT,NEAMȚ,BOTEȘTI,1985,1018,967,51.28,48.71,2
121876,NT,NEAMȚ,BOZIENI,1298,1049,249,80.81,19.18,2
121938,NT,NEAMȚ,BRUSTURI,1775,1241,534,69.91,30.08,2
122061,NT,NEAMȚ,CÂNDEȘTI,1726,1003,723,58.11,41.88,2
122025,NT,NEAMȚ,CEAHLĂU,1409,620,789,44.00,55.99,1
120888,NT,NEAMȚ,CORDUN,3256,1559,1697,47.88,52.11,1
122132,NT,NEAMȚ,COSTIȘA,1661,1063,598,63.99,36.00,2
122187,NT,NEAMȚ,CRĂCĂOANI,2054,1309,745,63.72,36.27,2
122249,NT,NEAMȚ,DĂMUC,1353,489,864,36.14,63.85,1
122285,NT,NEAMȚ,DOBRENI,912,516,396,56.57,43.42,2
125098,NT,NEAMȚ,DOCHIA,1159,678,481,58.49,41.50,2
122347,NT,NEAMȚ,DOLJEȘTI,2673,1419,1254,53.08,46.91,2
125132,NT,NEAMȚ,DRĂGĂNEȘTI,799,551,248,68.96,31.03,2
122392,NT,NEAMȚ,DRAGOMIREȘTI,1012,610,402,60.27,39.72,2
122463,NT,NEAMȚ,DULCEȘTI,1574,1132,442,71.91,28.08,2
120771,NT,NEAMȚ,DUMBRAVA ROȘIE,3751,1791,1960,47.74,52.25,1
122551,NT,NEAMȚ,FARCAȘA,1574,969,605,61.56,38.43,2
122613,NT,NEAMȚ,FĂUREI,1197,898,299,75.02,24.97,2
125150,NT,NEAMȚ,GÂDINȚI,1087,760,327,69.91,30.08,2
122828,NT,NEAMȚ,GÂRCINA,2083,1059,1024,50.84,49.15,2
122668,NT,NEAMȚ,GHERĂEȘTI,2356,1125,1231,47.75,52.24,1
125114,NT,NEAMȚ,GHINDĂOANI,967,560,407,57.91,42.08,2
122702,NT,NEAMȚ,GIROV,2431,1313,1118,54.01,45.98,2
122864,NT,NEAMȚ,GRINȚIEȘ,1218,705,513,57.88,42.11,2
122908,NT,NEAMȚ,GRUMĂZEȘTI,2415,1713,702,70.93,29.06,2
122953,NT,NEAMȚ,HANGU,1888,1095,793,57.99,42.00,2
120922,NT,NEAMȚ,HORIA,3119,1692,1427,54.24,45.75,2
123013,NT,NEAMȚ,ICUȘEȘTI,1800,990,810,55.00,45.00,2
123102,NT,NEAMȚ,ION CREANGĂ,2689,1826,863,67.90,32.09,2
123175,NT,NEAMȚ,MĂRGINENI,1465,965,500,65.87,34.12,2
123228,NT,NEAMȚ,MOLDOVENI,1045,546,499,52.24,47.75,2
125169,NT,NEAMȚ,NEGREȘTI,944,621,323,65.78,34.21,2
123255,NT,NEAMȚ,ONICENI,1690,1415,275,83.72,16.27,2
125141,NT,NEAMȚ,PÂNCEȘTI,626,441,185,70.44,29.55,2
123601,NT,NEAMȚ,PÂNGĂRAȚI,2539,1061,1478,41.78,58.21,1
123371,NT,NEAMȚ,PĂSTRĂVENI,1714,1256,458,73.27,26.72,2
123424,NT,NEAMȚ,PETRICANI,2506,1672,834,66.71,33.28,2
120726,NT,NEAMȚ,PIATRA-NEAMȚ,53537,23451,30086,43.80,56.19,1
123479,NT,NEAMȚ,PIATRA ȘOIMULUI,3243,2042,1201,62.96,37.03,2
123521,NT,NEAMȚ,PIPIRIG,3855,2354,1501,61.06,38.93,2
123674,NT,NEAMȚ,PODOLENI,2496,1589,907,63.66,36.33,2
123790,NT,NEAMȚ,POIANA TEIULUI,2318,1279,1039,55.17,44.82,2
123709,NT,NEAMȚ,POIENARI,742,476,266,64.15,35.84,2
123914,NT,NEAMȚ,RĂUCEȘTI,3714,2533,1181,68.20,31.79,2
123969,NT,NEAMȚ,RĂZBOIENI,1253,881,372,70.31,29.68,2
124028,NT,NEAMȚ,REDIU,2196,1293,903,58.87,41.12,2
120860,NT,NEAMȚ,ROMAN,30654,15164,15490,49.46,50.53,1
124073,NT,NEAMȚ,ROMÂNI,2164,1506,658,69.59,30.40,2
124117,NT,NEAMȚ,ROZNOV,4882,2959,1923,60.61,39.38,2
125105,NT,NEAMȚ,RUGINOASA,1123,675,448,60.10,39.89,2
124206,NT,NEAMȚ,SĂBĂOANI,4066,2149,1917,52.85,47.14,2
124153,NT,NEAMȚ,SAGNA,1949,1077,872,55.25,44.74,2
120824,NT,NEAMȚ,SĂVINEȘTI,2795,1559,1236,55.77,44.22,2
124233,NT,NEAMȚ,SECUIENI,1413,821,592,58.10,41.89,2
124331,NT,NEAMȚ,STĂNIȚA,925,615,310,66.48,33.51,2
124411,NT,NEAMȚ,ȘTEFAN CEL MARE,1898,1250,648,65.85,34.14,2
124634,NT,NEAMȚ,TĂMĂȘENI,3190,1172,2018,36.73,63.26,1
124493,NT,NEAMȚ,TARCĂU,1767,835,932,47.25,52.74,1
121055,NT,NEAMȚ,TÂRGU NEAMȚ,10852,6592,4260,60.74,39.25,2
124563,NT,NEAMȚ,TAȘCA,1326,628,698,47.36,52.63,1
124616,NT,NEAMȚ,TAZLĂU,1303,808,495,62.01,37.98,2
124803,NT,NEAMȚ,ȚIBUCANI,2108,1495,613,70.92,29.07,2
124661,NT,NEAMȚ,TIMIȘEȘTI,1844,1411,433,76.51,23.48,2
124723,NT,NEAMȚ,TRIFEȘTI,2339,1594,745,68.14,31.85,2
124750,NT,NEAMȚ,TUPILAȚI,1187,823,364,69.33,30.66,2
124849,NT,NEAMȚ,URECHENI,1644,1208,436,73.47,26.52,2
124885,NT,NEAMȚ,VALEA URSULUI,1755,1421,334,80.96,19.03,2
125123,NT,NEAMȚ,VĂLENI,721,583,138,80.85,19.14,2
125016,NT,NEAMȚ,VÂNĂTORI-NEAMȚ,3837,2457,1380,64.03,35.96,2
125061,NT,NEAMȚ,ZĂNEȘTI,2768,1604,1164,57.94,42.05,2
125659,OT,OLT,BĂBICIU,1580,1150,430,72.78,27.21,2
125677,OT,OLT,BALDOVINEȘTI,826,595,231,72.03,27.96,2
125418,OT,OLT,BALȘ,9128,5294,3834,57.99,42.00,2
130286,OT,OLT,BĂLTENI,951,678,273,71.29,28.70,2
125757,OT,OLT,BĂRĂȘTI,1493,1044,449,69.92,30.07,2
125846,OT,OLT,BÂRZA,1429,997,432,69.76,30.23,2
125873,OT,OLT,BOBICEȘTI,1630,1130,500,69.32,30.67,2
126022,OT,OLT,BRÂNCOVENI,1828,1405,423,76.85,23.14,2
125962,OT,OLT,BRASTAVĂȚU,2480,1515,965,61.08,38.91,2
125999,OT,OLT,BREBENI,1578,1013,565,64.19,35.80,2
126077,OT,OLT,BUCINIȘU,1025,713,312,69.56,30.43,2
130295,OT,OLT,CĂLUI,953,730,223,76.60,23.39,2
125472,OT,OLT,CARACAL,17417,10785,6632,61.92,38.07,2
126166,OT,OLT,CÂRLOGANI,1478,996,482,67.38,32.61,2
126102,OT,OLT,CEZIENI,1130,888,242,78.58,21.41,2
126148,OT,OLT,CILIENI,1687,1081,606,64.07,35.92,2
126228,OT,OLT,COLONEȘTI,1470,1132,338,77.00,22.99,2
125542,OT,OLT,CORABIA,8852,5683,3169,64.20,35.79,2
126326,OT,OLT,CORBU,1463,1109,354,75.80,24.19,2
126380,OT,OLT,COTEANA,1692,1378,314,81.44,18.55,2
126406,OT,OLT,CRÂMPOIA,2295,825,1470,35.94,64.05,1
126503,OT,OLT,CUNGREA,1450,901,549,62.13,37.86,2
126433,OT,OLT,CURTIȘOARA,2755,1701,1054,61.74,38.25,2
126585,OT,OLT,DĂNEASA,2206,1740,466,78.87,21.12,2
126647,OT,OLT,DEVESELU,1904,1242,662,65.23,34.76,2
126674,OT,OLT,DOBREȚU,836,578,258,69.13,30.86,2
126718,OT,OLT,DOBROSLOVENI,2167,1528,639,70.51,29.48,2
126772,OT,OLT,DOBROTEASA,1161,841,320,72.43,27.56,2
126825,OT,OLT,DOBRUN,1127,1077,50,95.56,4.43,2
125622,OT,OLT,DRĂGĂNEȘTI-OLT,5427,3369,2058,62.07,37.92,2
125490,OT,OLT,DRĂGHICENI,1204,951,253,78.98,21.01,2
126905,OT,OLT,FĂGEȚELU,820,566,254,69.02,30.97,2
126978,OT,OLT,FĂLCOIU,2142,1753,389,81.83,18.16,2
127019,OT,OLT,FĂRCAȘELE,2664,1898,766,71.24,28.75,2
127064,OT,OLT,GĂNEASA,2555,1811,744,70.88,29.11,2
125588,OT,OLT,GÂRCOV,1307,955,352,73.06,26.93,2
130302,OT,OLT,GĂVĂNEȘTI,1335,1045,290,78.27,21.72,2
130311,OT,OLT,GHIMPEȚENI,913,620,293,67.90,32.09,2
127126,OT,OLT,GIUVĂRĂȘTI,1295,907,388,70.03,29.96,2
127144,OT,OLT,GOSTAVĂȚU,1771,1293,478,73.00,26.99,2
127171,OT,OLT,GRĂDINARI,1601,1290,311,80.57,19.42,2
130320,OT,OLT,GRĂDINILE,1052,816,236,77.56,22.43,2
127224,OT,OLT,GROJDIBODU,1875,1399,476,74.61,25.38,2
130339,OT,OLT,GURA PADINII,1098,835,263,76.04,23.95,2
127251,OT,OLT,IANCA,2469,1863,606,75.45,24.54,2
127288,OT,OLT,IANCU JIANU,2260,1237,1023,54.73,45.26,2
127322,OT,OLT,ICOANA,1227,900,327,73.34,26.65,2
130348,OT,OLT,IPOTESTI,931,728,203,78.19,21.80,2
127368,OT,OLT,IZBICENI,2571,1323,1248,51.45,48.54,2
127386,OT,OLT,IZVOARELE,1801,1357,444,75.34,24.65,2
127411,OT,OLT,LELEASCA,1234,912,322,73.90,26.09,2
127493,OT,OLT,MĂRUNȚEI,1967,1323,644,67.25,32.74,2
127536,OT,OLT,MIHĂEȘTI,1173,551,622,46.97,53.02,1
127563,OT,OLT,MILCOV,987,703,284,71.22,28.77,2
127625,OT,OLT,MORUNGLAV,1393,1047,346,75.16,24.83,2
127689,OT,OLT,MOVILENI,1995,1620,375,81.20,18.79,2
127714,OT,OLT,NICOLAE TITULESCU,890,738,152,82.92,17.07,2
127750,OT,OLT,OBÂRȘIA,1585,1063,522,67.06,32.93,2
127812,OT,OLT,OBOGA,1085,878,207,80.92,19.07,2
127858,OT,OLT,OPORELU,920,691,229,75.10,24.89,2
127901,OT,OLT,OPTAȘI-MĂGURA,941,757,184,80.44,19.55,2
127938,OT,OLT,ORLEA,1380,959,421,69.49,30.50,2
130357,OT,OLT,OSICA DE JOS,983,749,234,76.19,23.80,2
127983,OT,OLT,OSICA DE SUS,2566,1453,1113,56.62,43.37,2
128178,OT,OLT,PÂRȘCOVENI,1547,1096,451,70.84,29.15,2
128052,OT,OLT,PERIEȚI,1128,733,395,64.98,35.01,2
128105,OT,OLT,PIATRA-OLT,3940,2356,1584,59.79,40.20,2
128221,OT,OLT,PLEȘOIU,1887,1300,587,68.89,31.10,2
128301,OT,OLT,POBORU,1417,1036,381,73.11,26.88,2
128374,OT,OLT,POTCOAVA,3657,2475,1182,67.67,32.32,2
128436,OT,OLT,PRISEACA,1256,721,535,57.40,42.59,2
128472,OT,OLT,RADOMIREȘTI,1863,1294,569,69.45,30.54,2
128524,OT,OLT,REDEA,1704,1213,491,71.18,28.81,2
128560,OT,OLT,ROTUNDA,1644,1182,462,71.89,28.10,2
128588,OT,OLT,RUSĂNEȘTI,2408,1286,1122,53.40,46.59,2
128882,OT,OLT,SÂMBUREȘTI,1058,749,309,70.79,29.20,2
130366,OT,OLT,SÂRBII - MĂGURA,1311,983,328,74.98,25.01,2
128613,OT,OLT,SCĂRIȘOARA,1264,762,502,60.28,39.71,2
128659,OT,OLT,SCHITU,1475,1000,475,67.79,32.20,2
128711,OT,OLT,SCORNICEȘTI,7557,3864,3693,51.13,48.86,2
128864,OT,OLT,SEACA,980,709,271,72.34,27.65,2
129246,OT,OLT,ȘERBĂNEȘTI,1683,1162,521,69.04,30.95,2
125347,OT,OLT,SLATINA,39992,21295,18697,53.24,46.75,2
125374,OT,OLT,SLĂTIOARA,1696,1053,643,62.08,37.91,2
130384,OT,OLT,ȘOPÂRLIȚA,901,696,205,77.24,22.75,2
128962,OT,OLT,SPINENI,1292,836,456,64.70,35.29,2
129040,OT,OLT,SPRÂNCENATA,1378,983,395,71.33,28.66,2
129282,OT,OLT,ȘTEFAN CEL MARE,1127,731,396,64.86,35.13,2
129095,OT,OLT,STOENEȘTI,1363,900,463,66.03,33.96,2
129111,OT,OLT,STOICĂNEȘTI,1292,1055,237,81.65,18.34,2
129139,OT,OLT,STREJEȘTI,1926,1454,472,75.49,24.50,2
129184,OT,OLT,STUDINA,1333,755,578,56.63,43.36,2
129317,OT,OLT,TĂTULEȘTI,986,743,243,75.35,24.64,2
129380,OT,OLT,TESLUI,1510,1051,459,69.60,30.39,2
129460,OT,OLT,TIA MARE,2477,1684,793,67.98,32.01,2
129503,OT,OLT,TOPANA,676,515,161,76.18,23.81,2
129567,OT,OLT,TRAIAN,1544,915,629,59.26,40.73,2
129585,OT,OLT,TUFENI,1810,1393,417,76.96,23.03,2
129629,OT,OLT,URZICA,1269,517,752,40.74,59.25,1
129718,OT,OLT,VĂDASTRA,965,748,217,77.51,22.48,2
129745,OT,OLT,VĂDĂSTRIȚA,1788,880,908,49.21,50.78,1
129987,OT,OLT,VÂLCELE,1535,1052,483,68.53,31.46,2
129656,OT,OLT,VALEA MARE,2102,1452,650,69.07,30.92,2
129763,OT,OLT,VĂLENI,1591,1140,451,71.65,28.34,2
129816,OT,OLT,VERGULEASA,2131,1525,606,71.56,28.43,2
129898,OT,OLT,VIȘINA,1934,1308,626,67.63,32.36,2
130375,OT,OLT,VIȘINA NOUĂ,1030,713,317,69.22,30.77,2
129914,OT,OLT,VITOMIREȘTI,1566,1174,392,74.96,25.03,2
130026,OT,OLT,VLĂDILA,1154,757,397,65.59,34.40,2
130062,OT,OLT,VOINEASA,1212,936,276,77.22,22.77,2
130124,OT,OLT,VULPENI,1319,890,429,67.47,32.52,2
130231,OT,OLT,VULTUREȘTI,1369,999,370,72.97,27.02,2
131899,PH,PRAHOVA,ADUNAȚI,1212,671,541,55.36,44.63,2
131933,PH,PRAHOVA,ALBEȘTI-PALEOLOGU,2800,1442,1358,51.50,48.50,2
131988,PH,PRAHOVA,ALUNIȘ,2095,1366,729,65.20,34.79,2
132011,PH,PRAHOVA,APOSTOLACHE,1161,416,745,35.83,64.16,1
132075,PH,PRAHOVA,ARICEȘTII RAHTIVANI,4793,2564,2229,53.49,46.50,2
132137,PH,PRAHOVA,ARICEȘTII ZELETIN,775,356,419,45.93,54.06,1
130954,PH,PRAHOVA,AZUGA,3058,1332,1726,43.55,56.44,1
132164,PH,PRAHOVA,BABA ANA,2098,1068,1030,50.90,49.09,2
130981,PH,PRAHOVA,BĂICOI,10773,5306,5467,49.25,50.74,1
132226,PH,PRAHOVA,BALTA DOAMNEI,1341,794,547,59.20,40.79,2
132271,PH,PRAHOVA,BĂLȚEȘTI,1804,815,989,45.17,54.82,1
132315,PH,PRAHOVA,BĂNEȘTI,3422,1733,1689,50.64,49.35,2
130552,PH,PRAHOVA,BĂRCĂNEȘTI,4455,2121,2334,47.60,52.39,1
136278,PH,PRAHOVA,BĂTRÂNI,1136,596,540,52.46,47.53,2
130614,PH,PRAHOVA,BERCENI,3171,1915,1256,60.39,39.60,2
132342,PH,PRAHOVA,BERTEA,1549,800,749,51.64,48.35,2
130678,PH,PRAHOVA,BLEJOI,4980,2312,2668,46.42,53.57,1
132379,PH,PRAHOVA,BOLDEȘTI-GRĂDIȘTEA,971,445,526,45.82,54.17,1
131069,PH,PRAHOVA,BOLDEȘTI-SCĂENI,6507,2861,3646,43.96,56.03,1
130712,PH,PRAHOVA,BRAZI,4354,1857,2497,42.65,57.34,1
131103,PH,PRAHOVA,BREAZA,10070,4710,5360,46.77,53.22,1
132404,PH,PRAHOVA,BREBU,4195,1658,2537,39.52,60.47,1
130785,PH,PRAHOVA,BUCOV,5777,2322,3455,40.19,59.80,1
131210,PH,PRAHOVA,BUȘTENI,7091,2453,4638,34.59,65.40,1
132459,PH,PRAHOVA,CĂLUGĂRENI,649,397,252,61.17,38.82,2
131256,PH,PRAHOVA,CÂMPINA,21661,9097,12564,41.99,58.00,1
132486,PH,PRAHOVA,CĂRBUNEȘTI,735,420,315,57.14,42.85,2
132510,PH,PRAHOVA,CEPTURA,2301,1244,1057,54.06,45.93,2
132574,PH,PRAHOVA,CERAȘU,2703,1734,969,64.15,35.84,2
132645,PH,PRAHOVA,CHIOJDEANCA,1007,594,413,58.98,41.01,2
132681,PH,PRAHOVA,CIORANI,3960,2959,1001,74.72,25.27,2
136241,PH,PRAHOVA,COCORĂȘTII COLȚ,1542,564,978,36.57,63.42,1
132716,PH,PRAHOVA,COCORĂȘTII MISLII,1992,893,1099,44.82,55.17,1
132752,PH,PRAHOVA,COLCEAG,2436,1412,1024,57.96,42.03,2
131336,PH,PRAHOVA,COMARNIC,6776,2830,3946,41.76,58.23,1
132805,PH,PRAHOVA,CORNU,2989,2056,933,68.78,31.21,2
132841,PH,PRAHOVA,COSMINELE,647,287,360,44.35,55.64,1
133018,PH,PRAHOVA,DRĂGĂNEȘTI,2289,1121,1168,48.97,51.02,1
132896,PH,PRAHOVA,DRAJNA,3065,1487,1578,48.51,51.48,1
133090,PH,PRAHOVA,DUMBRAVA,2173,1109,1064,51.03,48.96,2
131461,PH,PRAHOVA,DUMBRĂVEȘTI,1993,1102,891,55.29,44.70,2
133278,PH,PRAHOVA,FÂNTÂNELE,1112,600,512,53.95,46.04,2
133161,PH,PRAHOVA,FILIPEȘTII DE PĂDURE,5141,2674,2467,52.01,47.98,2
133214,PH,PRAHOVA,FILIPEȘTII DE TÂRG,4014,2407,1607,59.96,40.03,2
133330,PH,PRAHOVA,FLOREȘTI,3836,2274,1562,59.28,40.71,2
133394,PH,PRAHOVA,FULGA,1502,1090,412,72.56,27.43,2
133429,PH,PRAHOVA,GHERGHIȚA,1119,739,380,66.04,33.95,2
133508,PH,PRAHOVA,GORGOTA,2803,1108,1695,39.52,60.47,1
133562,PH,PRAHOVA,GORNET,1737,943,794,54.28,45.71,2
133615,PH,PRAHOVA,GORNET-CRICOV,1210,585,625,48.34,51.65,1
133688,PH,PRAHOVA,GURA VADULUI,1159,668,491,57.63,42.36,2
131835,PH,PRAHOVA,GURA VITIOAREI,3025,1707,1318,56.42,43.57,2
133722,PH,PRAHOVA,IORDĂCHEANU,2632,1388,1244,52.73,47.26,2
133795,PH,PRAHOVA,IZVOARELE,3624,1904,1720,52.53,47.46,2
133866,PH,PRAHOVA,JUGURENI,435,340,95,78.16,21.83,2
133919,PH,PRAHOVA,LAPOȘ,657,498,159,75.79,24.20,2
133964,PH,PRAHOVA,LIPĂNEȘTI,2703,1185,1518,43.84,56.15,1
134014,PH,PRAHOVA,MĂGURELE,2450,1054,1396,43.02,56.97,1
134050,PH,PRAHOVA,MĂGURENI,3234,1762,1472,54.48,45.51,2
134096,PH,PRAHOVA,MĂNECIU,5737,3000,2737,52.29,47.70,2
134194,PH,PRAHOVA,MĂNEȘTI,2210,964,1246,43.61,56.38,1
131407,PH,PRAHOVA,MIZIL,7254,4414,2840,60.84,39.15,2
136250,PH,PRAHOVA,OLARI,1184,879,305,74.23,25.76,2
134336,PH,PRAHOVA,PĂCUREȚI,1028,583,445,56.71,43.28,2
130847,PH,PRAHOVA,PĂULEȘTI,4126,2075,2051,50.29,49.70,2
130534,PH,PRAHOVA,PLOIEȘTI,128105,54374,73731,42.44,57.55,1
131443,PH,PRAHOVA,PLOPENI,4919,2546,2373,51.75,48.24,2
134390,PH,PRAHOVA,PLOPU,1536,688,848,44.79,55.20,1
134443,PH,PRAHOVA,PODENII NOI,2497,1145,1352,45.85,54.14,1
131274,PH,PRAHOVA,POIANA CÂMPINA,3086,1113,1973,36.06,63.93,1
134559,PH,PRAHOVA,POIENARII BURCHII,2897,1319,1578,45.52,54.47,1
134648,PH,PRAHOVA,POSEȘTI,2070,1121,949,54.15,45.84,2
134755,PH,PRAHOVA,PREDEAL-SĂRARI,1222,685,537,56.05,43.94,2
134853,PH,PRAHOVA,PROVIȚA DE JOS,1235,543,692,43.96,56.03,1
134899,PH,PRAHOVA,PROVIȚA DE SUS,1228,587,641,47.80,52.19,1
134942,PH,PRAHOVA,PUCHENII MARI,4912,1911,3001,38.90,61.09,1
135020,PH,PRAHOVA,RÂFOV,2944,1842,1102,62.56,37.43,2
135128,PH,PRAHOVA,SALCIA,522,326,196,62.45,37.54,2
135146,PH,PRAHOVA,SĂLCIILE,1143,480,663,41.99,58.00,1
135244,PH,PRAHOVA,SÂNGERU,2169,1126,1043,51.91,48.08,2
135164,PH,PRAHOVA,SCORȚENI,3171,1594,1577,50.26,49.73,2
135226,PH,PRAHOVA,SECĂRIA,732,314,418,42.89,57.10,1
131540,PH,PRAHOVA,SINAIA,8312,3306,5006,39.77,60.22,1
135431,PH,PRAHOVA,ȘIRNA,2535,1371,1164,54.08,45.91,2
131577,PH,PRAHOVA,SLĂNIC,3435,1944,1491,56.59,43.40,2
135501,PH,PRAHOVA,ȘOIMARI,1477,699,778,47.32,52.67,1
135547,PH,PRAHOVA,ȘOTRILE,1740,881,859,50.63,49.36,2
135315,PH,PRAHOVA,STARCHIOJD,1976,1252,724,63.36,36.63,2
135618,PH,PRAHOVA,ȘTEFEȘTI,1280,734,546,57.34,42.65,2
135404,PH,PRAHOVA,SURANI,984,277,707,28.15,71.84,1
135654,PH,PRAHOVA,TALEA,729,441,288,60.49,39.50,2
130892,PH,PRAHOVA,TÂRGȘORU VECHI,4957,1770,3187,35.70,64.29,1
135681,PH,PRAHOVA,TĂTARU,582,206,376,35.39,64.60,1
135725,PH,PRAHOVA,TEIȘANI,1981,1011,970,51.03,48.96,2
135789,PH,PRAHOVA,TELEGA,3207,1617,1590,50.42,49.57,2
135850,PH,PRAHOVA,TINOSU,1301,576,725,44.27,55.72,1
135896,PH,PRAHOVA,TOMȘANI,2200,1287,913,58.50,41.50,2
131620,PH,PRAHOVA,URLAȚI,5556,2620,2936,47.15,52.84,1
136269,PH,PRAHOVA,VADU SĂPAT,783,407,376,51.97,48.02,2
136198,PH,PRAHOVA,VÂLCĂNEȘTI,2125,1071,1054,50.40,49.60,2
135949,PH,PRAHOVA,VALEA CĂLUGĂREASCĂ,5281,3065,2216,58.03,41.96,2
136107,PH,PRAHOVA,VALEA DOFTANEI,3767,1680,2087,44.59,55.40,1
131817,PH,PRAHOVA,VĂLENII DE MUNTE,7725,3974,3751,51.44,48.55,2
136134,PH,PRAHOVA,VĂRBILĂU,3524,2275,1249,64.55,35.44,2
139937,SJ,SĂLAJ,AGRIJ,709,384,325,54.16,45.83,2
139982,SJ,SĂLAJ,ALMAȘU,1311,330,981,25.17,74.82,1
140084,SJ,SĂLAJ,BĂBENI,1045,467,578,44.68,55.31,1
140146,SJ,SĂLAJ,BĂLAN,2140,1104,1036,51.58,48.41,2
140208,SJ,SĂLAJ,BĂNIȘOR,1140,410,730,35.96,64.03,1
140244,SJ,SĂLAJ,BENESAT,872,279,593,31.99,68.00,1
140280,SJ,SĂLAJ,BOBOTA,1840,876,964,47.60,52.39,1
140324,SJ,SĂLAJ,BOCȘA,1560,401,1159,25.70,74.29,1
180037,SJ,SĂLAJ,BOGHIȘ,815,170,645,20.85,79.14,1
140379,SJ,SĂLAJ,BUCIUMI,1570,738,832,47.00,52.99,1
140440,SJ,SĂLAJ,CAMĂR,847,340,507,40.14,59.85,1
140477,SJ,SĂLAJ,CARASTELEC,543,197,346,36.27,63.72,1
139740,SJ,SĂLAJ,CEHU SILVANIEI,3605,1082,2523,30.01,69.98,1
140501,SJ,SĂLAJ,CHIEȘD,1181,671,510,56.81,43.18,2
140547,SJ,SĂLAJ,CIZER,1132,355,777,31.36,68.63,1
140583,SJ,SĂLAJ,COȘEIU,614,226,388,36.80,63.19,1
140627,SJ,SĂLAJ,CRASNA,2961,722,2239,24.38,75.61,1
140672,SJ,SĂLAJ,CREACA,1569,823,746,52.45,47.54,2
140823,SJ,SĂLAJ,CRIȘENI,1647,558,1089,33.87,66.12,1
140770,SJ,SĂLAJ,CRISTOLȚ,686,322,364,46.93,53.06,1
140869,SJ,SĂLAJ,CUZĂPLAC,1215,781,434,64.27,35.72,2
140958,SJ,SĂLAJ,DOBRIN,795,241,554,30.31,69.68,1
141027,SJ,SĂLAJ,DRAGU,685,323,362,47.15,52.84,1
141081,SJ,SĂLAJ,FILDU DE JOS,923,458,465,49.62,50.37,1
141134,SJ,SĂLAJ,GÂLGĂU,1565,534,1031,34.12,65.87,1
141232,SJ,SĂLAJ,GÂRBOU,1100,552,548,50.18,49.81,2
141312,SJ,SĂLAJ,HALMĂȘD,1247,560,687,44.90,55.09,1
141376,SJ,SĂLAJ,HERECLEAN,1995,620,1375,31.07,68.92,1
141447,SJ,SĂLAJ,HIDA,1501,679,822,45.23,54.76,1
141535,SJ,SĂLAJ,HOROATU CRASNEI,1377,533,844,38.70,61.29,1
141580,SJ,SĂLAJ,ILEANDA,1380,597,783,43.26,56.73,1
141722,SJ,SĂLAJ,IP,1708,493,1215,28.86,71.13,1
139811,SJ,SĂLAJ,JIBOU,5774,2866,2908,49.63,50.36,1
141786,SJ,SĂLAJ,LETCA,1228,637,591,51.87,48.12,2
141884,SJ,SĂLAJ,LOZNA,647,341,306,52.70,47.29,2
142006,SJ,SĂLAJ,MĂERIȘTE,1580,581,999,36.77,63.22,1
141946,SJ,SĂLAJ,MARCA,1367,400,967,29.26,70.73,1
142079,SJ,SĂLAJ,MESEȘENII DE JOS,1693,624,1069,36.85,63.14,1
142122,SJ,SĂLAJ,MIRȘID,1304,728,576,55.82,44.17,2
142177,SJ,SĂLAJ,NĂPRADEA,1431,723,708,50.52,49.47,2
142239,SJ,SĂLAJ,NUȘFALĂU,1709,425,1284,24.86,75.13,1
142284,SJ,SĂLAJ,PERICEI,1772,318,1454,17.94,82.05,1
142337,SJ,SĂLAJ,PLOPIȘ,1114,223,891,20.01,79.98,1
142373,SJ,SĂLAJ,POIANA BLENCHII,719,380,339,52.85,47.14,2
142426,SJ,SĂLAJ,ROMÂNAȘI,1608,611,997,37.99,62.00,1
142499,SJ,SĂLAJ,RUS,665,343,322,51.57,48.42,2
142612,SJ,SĂLAJ,SÂG,1319,458,861,34.72,65.27,1
142550,SJ,SĂLAJ,SĂLĂȚIG,1371,388,983,28.30,71.69,1
142854,SJ,SĂLAJ,ȘAMȘUD,685,186,499,27.15,72.84,1
142676,SJ,SĂLAJ,SÂNMIHAIU ALMAȘULUI,878,458,420,52.16,47.83,2
142881,SJ,SĂLAJ,ȘĂRMĂȘAG,2839,615,2224,21.66,78.33,1
179695,SJ,SĂLAJ,ȘIMIȘNA,670,436,234,65.07,34.92,2
139884,SJ,SĂLAJ,ȘIMLEU SILVANIEI,7449,2384,5065,32.00,67.99,1
142710,SJ,SĂLAJ,SOMEȘ-ODORHEI,1588,849,739,53.46,46.53,2
142774,SJ,SĂLAJ,SURDUC,2291,1307,984,57.04,42.95,2
179631,SJ,SĂLAJ,TREZNEA,594,220,374,37.03,62.96,1
142952,SJ,SĂLAJ,VALCĂU DE JOS,1677,618,1059,36.85,63.14,1
143021,SJ,SĂLAJ,VÂRȘOLȚ,970,214,756,22.06,77.93,1
139704,SJ,SĂLAJ,ZALĂU,33500,10933,22567,32.63,67.36,1
143067,SJ,SĂLAJ,ZALHA,559,249,310,44.54,55.45,1
143147,SJ,SĂLAJ,ZIMBOR,700,241,459,34.42,65.57,1
136713,SM,SATU MARE,ACÂȘ,1216,493,723,40.54,59.45,1
179873,SM,SATU MARE,AGRIȘ,757,141,616,18.62,81.37,1
136768,SM,SATU MARE,ANDRID,1173,445,728,37.93,62.06,1
136802,SM,SATU MARE,APA,1363,669,694,49.08,50.91,1
136848,SM,SATU MARE,ARDUD,3166,1078,2088,34.04,65.95,1
137103,SM,SATU MARE,BÂRSĂU,1271,658,613,51.77,48.22,2
136919,SM,SATU MARE,BĂTARCI,1400,603,797,43.07,56.92,1
136964,SM,SATU MARE,BELTIUG,1605,398,1207,24.79,75.20,1
137032,SM,SATU MARE,BERVENI,1203,468,735,38.90,61.09,1
137069,SM,SATU MARE,BIXAD,2005,601,1404,29.97,70.02,1
137130,SM,SATU MARE,BOGDAND,1124,401,723,35.67,64.32,1
137185,SM,SATU MARE,BOTIZ,1625,411,1214,25.29,74.70,1
137229,SM,SATU MARE,CĂLINEȘTI-OAȘ,1692,640,1052,37.82,62.17,1
137274,SM,SATU MARE,CĂMĂRZANA,743,161,582,21.66,78.33,1
179677,SM,SATU MARE,CĂMIN,644,69,575,10.71,89.28,1
136553,SM,SATU MARE,CĂPLENI,1193,100,1093,8.38,91.61,1
136526,SM,SATU MARE,CAREI,10796,3411,7385,31.59,68.40,1
137292,SM,SATU MARE,CĂUAȘ,1150,410,740,35.65,64.34,1
137363,SM,SATU MARE,CEHAL,930,463,467,49.78,50.21,1
137407,SM,SATU MARE,CERTEZE,1518,652,866,42.95,57.04,1
179882,SM,SATU MARE,CIUMEȘTI,463,75,388,16.19,83.80,1
137443,SM,SATU MARE,CRAIDOROLȚ,938,544,394,57.99,42.00,2
137504,SM,SATU MARE,CRUCIȘOR,1492,838,654,56.16,43.83,2
137540,SM,SATU MARE,CULCIU,1700,576,1124,33.88,66.11,1
137611,SM,SATU MARE,DOBA,1272,535,737,42.05,57.94,1
137675,SM,SATU MARE,DOROLȚ,1415,297,1118,20.98,79.01,1
137728,SM,SATU MARE,FOIENI,773,50,723,6.46,93.53,1
137746,SM,SATU MARE,GHERȚA MICĂ,948,500,448,52.74,47.25,2
137764,SM,SATU MARE,HALMEU,1732,538,1194,31.06,68.93,1
137844,SM,SATU MARE,HODOD,1066,268,798,25.14,74.85,1
137899,SM,SATU MARE,HOMOROADE,1090,624,466,57.24,42.75,2
137960,SM,SATU MARE,LAZURI,2277,383,1894,16.82,83.17,1
138039,SM,SATU MARE,LIVADA,2844,767,2077,26.96,73.03,1
138084,SM,SATU MARE,MEDIEȘU AURIT,3415,1694,1721,49.60,50.39,1
138164,SM,SATU MARE,MICULA,1455,469,986,32.23,67.76,1
138208,SM,SATU MARE,MOFTIN,1869,787,1082,42.10,57.89,1
136599,SM,SATU MARE,NEGREȘTI-OAȘ,6279,2903,3376,46.23,53.76,1
138280,SM,SATU MARE,ODOREU,2843,1274,1569,44.81,55.18,1
138351,SM,SATU MARE,ORAȘU NOU,1632,283,1349,17.34,82.65,1
138431,SM,SATU MARE,PĂULEȘTI,2552,913,1639,35.77,64.22,1
138501,SM,SATU MARE,PETREȘTI,637,100,537,15.69,84.30,1
138538,SM,SATU MARE,PIR,629,292,337,46.42,53.57,1
138574,SM,SATU MARE,PIȘCOLT,1588,699,889,44.01,55.98,1
138618,SM,SATU MARE,POMI,1149,599,550,52.13,47.86,2
180028,SM,SATU MARE,PORUMBEȘTI,1000,307,693,30.70,69.30,1
180091,SM,SATU MARE,RACȘA,1320,1087,233,82.34,17.65,2
138770,SM,SATU MARE,SĂCĂȘENI,486,189,297,38.88,61.11,1
138663,SM,SATU MARE,SANISLĂU,1657,673,984,40.61,59.38,1
138734,SM,SATU MARE,SANTĂU,1341,304,1037,22.66,77.33,1
136483,SM,SATU MARE,SATU MARE,58680,17615,41065,30.01,69.98,1
138805,SM,SATU MARE,SĂUCA,656,292,364,44.51,55.48,1
138869,SM,SATU MARE,SOCOND,1413,855,558,60.50,39.49,2
138921,SM,SATU MARE,SUPUR,1864,1138,726,61.05,38.94,2
139009,SM,SATU MARE,TARNA MARE,1527,626,901,40.99,59.00,1
139143,SM,SATU MARE,TÂRȘOLȚ,630,163,467,25.87,74.12,1
136642,SM,SATU MARE,TĂȘNAD,4724,1789,2935,37.87,62.12,1
139054,SM,SATU MARE,TEREBEȘTI,987,584,403,59.16,40.83,2
139107,SM,SATU MARE,TIREAM,956,409,547,42.78,57.21,1
139170,SM,SATU MARE,TURȚ,2633,1212,1421,46.03,53.96,1
139214,SM,SATU MARE,TURULUNG,1439,457,982,31.75,68.24,1
139250,SM,SATU MARE,URZICENI,662,76,586,11.48,88.51,1
139287,SM,SATU MARE,VALEA VINULUI,1163,600,563,51.59,48.40,2
139330,SM,SATU MARE,VAMA,1337,301,1036,22.51,77.48,1
139358,SM,SATU MARE,VETIȘ,1902,497,1405,26.13,73.86,1
139394,SM,SATU MARE,VIILE SATU MARE,1669,534,1135,31.99,68.00,1
143682,SB,SIBIU,AGNITA,5031,973,4058,19.34,80.65,1
146012,SB,SIBIU,ALMA,1223,526,697,43.00,56.99,1
143888,SB,SIBIU,ALȚÂNA,915,509,406,55.62,44.37,2
143922,SB,SIBIU,APOLDU DE JOS,843,233,610,27.63,72.36,1
143959,SB,SIBIU,ARPAȘU DE JOS,1488,313,1175,21.03,78.96,1
143995,SB,SIBIU,AȚEL,836,130,706,15.55,84.44,1
144054,SB,SIBIU,AVRIG,7695,1317,6378,17.11,82.88,1
144116,SB,SIBIU,AXENTE SEVER,1933,369,1564,19.08,80.91,1
144232,SB,SIBIU,BÂRGHIȘ,1111,321,790,28.89,71.10,1
144152,SB,SIBIU,BAZNA,1883,368,1515,19.54,80.45,1
144198,SB,SIBIU,BIERTAN,1412,555,857,39.30,60.69,1
144303,SB,SIBIU,BLĂJEL,1356,438,918,32.30,67.69,1
146021,SB,SIBIU,BOIȚA,866,149,717,17.20,82.79,1
144376,SB,SIBIU,BRĂDENI,746,162,584,21.71,78.28,1
144349,SB,SIBIU,BRATEIU,1638,254,1384,15.50,84.49,1
144410,SB,SIBIU,BRUIU,360,105,255,29.16,70.83,1
144508,SB,SIBIU,CÂRȚA,502,208,294,41.43,58.56,1
144535,SB,SIBIU,CÂRȚIȘOARA,826,263,563,31.84,68.15,1
144456,SB,SIBIU,CHIRPĂR,729,231,498,31.68,68.31,1
143735,SB,SIBIU,CISNĂDIE,8838,1565,7273,17.70,82.29,1
143771,SB,SIBIU,COPȘA MICĂ,2385,488,1897,20.46,79.53,1
143487,SB,SIBIU,CRISTIAN,2139,237,1902,11.07,88.92,1
144553,SB,SIBIU,DÂRLOS,1564,419,1145,26.79,73.20,1
143806,SB,SIBIU,DUMBRĂVENI,3897,1115,2782,28.61,71.38,1
144599,SB,SIBIU,GURA RÂULUI,2277,279,1998,12.25,87.74,1
144615,SB,SIBIU,HOGHILAG,1094,435,659,39.76,60.23,1
144651,SB,SIBIU,IACOBENI,1310,523,787,39.92,60.07,1
144713,SB,SIBIU,JINA,1682,216,1466,12.84,87.15,1
144731,SB,SIBIU,LASLEA,1778,869,909,48.87,51.12,1
144795,SB,SIBIU,LOAMNEȘ,1799,627,1172,34.85,65.14,1
144866,SB,SIBIU,LUDOȘ,387,133,254,34.36,65.63,1
144893,SB,SIBIU,MARPOD,513,116,397,22.61,77.38,1
143619,SB,SIBIU,MEDIAȘ,28473,5778,22695,20.29,79.70,1
144964,SB,SIBIU,MERGHINDEAL,680,280,400,41.17,58.82,1
144991,SB,SIBIU,MICĂSASA,1304,493,811,37.80,62.19,1
144928,SB,SIBIU,MIERCUREA SIBIULUI,2234,452,1782,20.23,79.76,1
145042,SB,SIBIU,MIHĂILENI,451,186,265,41.24,58.75,1
145104,SB,SIBIU,MOȘNA,1792,711,1081,39.67,60.32,1
145140,SB,SIBIU,NOCRICH,1445,259,1186,17.92,82.07,1
143851,SB,SIBIU,OCNA SIBIULUI,2358,533,1825,22.60,77.39,1
145202,SB,SIBIU,ORLAT,1838,198,1640,10.77,89.22,1
145220,SB,SIBIU,PĂUCA,1222,277,945,22.66,77.33,1
145275,SB,SIBIU,POIANA SIBIULUI,1102,203,899,18.42,81.57,1
143502,SB,SIBIU,POPLACA,975,127,848,13.02,86.97,1
145293,SB,SIBIU,PORUMBACU DE JOS,1891,596,1295,31.51,68.48,1
145355,SB,SIBIU,RACOVIȚA,1611,261,1350,16.20,83.79,1
143520,SB,SIBIU,RĂȘINARI,2778,314,2464,11.30,88.69,1
145382,SB,SIBIU,RÂU SADULUI,356,53,303,14.88,85.11,1
145408,SB,SIBIU,ROȘIA,2635,583,2052,22.12,77.87,1
145471,SB,SIBIU,SADU,1454,212,1242,14.58,85.41,1
145499,SB,SIBIU,SĂLIȘTE,3567,656,2911,18.39,81.60,1
145667,SB,SIBIU,ȘEICA MARE,2493,319,2174,12.79,87.20,1
145738,SB,SIBIU,ȘEICA MICĂ,861,384,477,44.59,55.40,1
143557,SB,SIBIU,ȘELIMBĂR,5046,924,4122,18.31,81.68,1
143450,SB,SIBIU,SIBIU,105412,19282,86130,18.29,81.70,1
145603,SB,SIBIU,SLIMNIC,1985,304,1681,15.31,84.68,1
145765,SB,SIBIU,ȘURA MARE,2165,346,1819,15.98,84.01,1
145792,SB,SIBIU,ȘURA MICĂ,1488,276,1212,18.54,81.45,1
145827,SB,SIBIU,TĂLMACIU,4101,852,3249,20.77,79.22,1
143646,SB,SIBIU,TÂRNAVA,1509,492,1017,32.60,67.39,1
145907,SB,SIBIU,TILIȘCA,915,221,694,24.15,75.84,1
145934,SB,SIBIU,TURNU ROȘU,1447,377,1070,26.05,73.94,1
145961,SB,SIBIU,VALEA VIILOR,1018,312,706,30.64,69.35,1
145998,SB,SIBIU,VURPĂR,1194,354,840,29.64,70.35,1
146799,SV,SUCEAVA,ADÂNCATA,2132,821,1311,38.50,61.49,1
146860,SV,SUCEAVA,ARBORE,2834,1182,1652,41.70,58.29,1
146904,SV,SUCEAVA,BAIA,2840,2003,837,70.52,29.47,2
151530,SV,SUCEAVA,BĂLĂCEANA,709,454,255,64.03,35.96,2
146995,SV,SUCEAVA,BĂLCĂUȚI,1303,715,588,54.87,45.12,2
151576,SV,SUCEAVA,BERCHIȘEȘTI,1449,817,632,56.38,43.61,2
147036,SV,SUCEAVA,BILCA,1418,637,781,44.92,55.07,1
147054,SV,SUCEAVA,BOGDĂNEȘTI,1821,1198,623,65.78,34.21,2
147072,SV,SUCEAVA,BOROAIA,2321,1606,715,69.19,30.80,2
147134,SV,SUCEAVA,BOSANCI,2480,758,1722,30.56,69.43,1
147161,SV,SUCEAVA,BOTOȘANA,1226,440,786,35.88,64.11,1
147205,SV,SUCEAVA,BREAZA,766,460,306,60.05,39.94,2
147241,SV,SUCEAVA,BRODINA,1642,639,1003,38.91,61.08,1
147358,SV,SUCEAVA,BROȘTENI,3114,1520,1594,48.81,51.18,1
147465,SV,SUCEAVA,BUNEȘTI,1197,655,542,54.72,45.27,2
151521,SV,SUCEAVA,BURLA,761,392,369,51.51,48.48,2
147526,SV,SUCEAVA,CACICA,2194,1073,1121,48.90,51.09,1
147633,SV,SUCEAVA,CAJVANA,2639,932,1707,35.31,64.68,1
147580,SV,SUCEAVA,CALAFINDEȘTI,1286,742,544,57.69,42.30,2
146502,SV,SUCEAVA,CÂMPULUNG MOLDOVENESC,10311,4043,6268,39.21,60.78,1
151503,SV,SUCEAVA,CAPU CÂMPULUI,1214,634,580,52.22,47.77,2
147713,SV,SUCEAVA,CÂRLIBABA,891,308,583,34.56,65.43,1
151451,SV,SUCEAVA,CIOCĂNEȘTI,847,266,581,31.40,68.59,1
151567,SV,SUCEAVA,CIPRIAN PORUMBESCU,855,593,262,69.35,30.64,2
151433,SV,SUCEAVA,COMĂNEȘTI,1122,526,596,46.88,53.11,1
147786,SV,SUCEAVA,CORNU LUNCII,3759,2363,1396,62.86,37.13,2
151497,SV,SUCEAVA,COȘNA,901,412,489,45.72,54.27,1
147884,SV,SUCEAVA,CRUCEA,1059,599,460,56.56,43.43,2
147937,SV,SUCEAVA,DĂRMĂNEȘTI,2817,1168,1649,41.46,58.53,1
148006,SV,SUCEAVA,DOLHASCA,4918,3245,1673,65.98,34.01,2
148097,SV,SUCEAVA,DOLHEȘTI,1821,1180,641,64.79,35.20,2
148131,SV,SUCEAVA,DORNA-ARINI,1710,759,951,44.38,55.61,1
148202,SV,SUCEAVA,DORNA CANDRENILOR,1598,417,1181,26.09,73.90,1
148293,SV,SUCEAVA,DORNEȘTI,1663,797,866,47.92,52.07,1
148328,SV,SUCEAVA,DRĂGOIEȘTI,1278,760,518,59.46,40.53,2
148382,SV,SUCEAVA,DRĂGUȘENI,1252,962,290,76.83,23.16,2
148426,SV,SUCEAVA,DUMBRĂVENI,3610,1887,1723,52.27,47.72,2
146539,SV,SUCEAVA,FĂLTICENI,14688,8984,5704,61.16,38.83,2
151488,SV,SUCEAVA,FÂNTÂNA MARE,1234,815,419,66.04,33.95,2
148453,SV,SUCEAVA,FÂNTÂNELE,1947,1074,873,55.16,44.83,2
148514,SV,SUCEAVA,FORĂȘTI,2529,1928,601,76.23,23.76,2
148612,SV,SUCEAVA,FRASIN,2989,1308,1681,43.76,56.23,1
148667,SV,SUCEAVA,FRĂTĂUȚII NOI,1918,966,952,50.36,49.63,2
148694,SV,SUCEAVA,FRĂTĂUȚII VECHI,1554,678,876,43.62,56.37,1
148729,SV,SUCEAVA,FRUMOSU,1837,681,1156,37.07,62.92,1
148765,SV,SUCEAVA,FUNDU MOLDOVEI,2216,730,1486,32.94,67.05,1
148872,SV,SUCEAVA,GĂLĂNEȘTI,929,523,406,56.29,43.70,2
148916,SV,SUCEAVA,GRĂMEȘTI,1367,848,519,62.03,37.96,2
148970,SV,SUCEAVA,GRĂNICEȘTI,2015,955,1060,47.39,52.60,1
146584,SV,SUCEAVA,GURA HUMORULUI,8033,3523,4510,43.85,56.14,1
151512,SV,SUCEAVA,HĂNȚEȘTI,1741,1081,660,62.09,37.90,2
151549,SV,SUCEAVA,HÂRTOP,1027,688,339,66.99,33.00,2
149101,SV,SUCEAVA,HORODNIC DE JOS,1008,397,611,39.38,60.61,1
151479,SV,SUCEAVA,HORODNIC DE SUS,1864,843,1021,45.22,54.77,1
149049,SV,SUCEAVA,HORODNICENI,1933,937,996,48.47,51.52,1
149138,SV,SUCEAVA,IACOBENI,1157,484,673,41.83,58.16,1
151442,SV,SUCEAVA,IASLOVĂȚ,1209,569,640,47.06,52.93,1
147660,SV,SUCEAVA,ILIȘEȘTI,1277,565,712,44.24,55.75,1
146281,SV,SUCEAVA,IPOTEȘTI,3012,974,2038,32.33,67.66,1
149183,SV,SUCEAVA,IZVOARELE SUCEVEI,870,325,545,37.35,62.64,1
149227,SV,SUCEAVA,LITENI,4245,2099,2146,49.44,50.55,1
149316,SV,SUCEAVA,MĂLINI,3592,2673,919,74.41,25.58,2
149370,SV,SUCEAVA,MĂNĂSTIREA HUMORULUI,1743,402,1341,23.06,76.93,1
149290,SV,SUCEAVA,MARGINEA,3666,1463,2203,39.90,60.09,1
146931,SV,SUCEAVA,MILIȘĂUȚI,2221,946,1275,42.59,57.40,1
146325,SV,SUCEAVA,MITOCU DRAGOMIRNEI,2221,972,1249,43.76,56.23,1
149414,SV,SUCEAVA,MOARA,2196,818,1378,37.24,62.75,1
149502,SV,SUCEAVA,MOLDOVA-SULIȚA,830,315,515,37.95,62.04,1
149539,SV,SUCEAVA,MOLDOVIȚA,2411,737,1674,30.56,69.43,1
149584,SV,SUCEAVA,MUȘENIȚA,918,509,409,55.44,44.55,2
149655,SV,SUCEAVA,OSTRA,1344,923,421,68.67,31.32,2
149753,SV,SUCEAVA,PĂLTINOASA,2783,1560,1223,56.05,43.94,2
149682,SV,SUCEAVA,PANACI,1274,554,720,43.48,56.51,1
149780,SV,SUCEAVA,PÂRTEȘTII DE JOS,1371,692,679,50.47,49.52,2
149833,SV,SUCEAVA,PĂTRĂUȚI,1789,964,825,53.88,46.11,2
149851,SV,SUCEAVA,POIANA STAMPEI,1366,727,639,53.22,46.77,2
151585,SV,SUCEAVA,POIENI-SOLCA,834,500,334,59.95,40.04,2
149931,SV,SUCEAVA,POJORÂTA,1761,744,1017,42.24,57.75,1
149968,SV,SUCEAVA,PREUTEȘTI,3437,2556,881,74.36,25.63,2
150043,SV,SUCEAVA,PUTNA,2001,1309,692,65.41,34.58,2
150070,SV,SUCEAVA,RĂDĂȘENI,1832,810,1022,44.21,55.78,1
146628,SV,SUCEAVA,RĂDĂUȚI,13545,5858,7687,43.24,56.75,1
150114,SV,SUCEAVA,RÂȘCA,2230,1641,589,73.58,26.41,2
150178,SV,SUCEAVA,SADOVA,1394,389,1005,27.90,72.09,1
146370,SV,SUCEAVA,SALCEA,3956,1678,2278,42.41,57.58,1
150445,SV,SUCEAVA,ȘARU DORNEI,2241,907,1334,40.47,59.52,1
150196,SV,SUCEAVA,SATU MARE,1593,789,804,49.52,50.47,1
146432,SV,SUCEAVA,ȘCHEIA,4754,1981,2773,41.67,58.32,1
151460,SV,SUCEAVA,ȘERBĂUȚI,1143,536,607,46.89,53.10,1
150221,SV,SUCEAVA,SIMINICEA,1277,828,449,64.83,35.16,2
146655,SV,SUCEAVA,SIRET,4169,2220,1949,53.25,46.74,2
150258,SV,SUCEAVA,SLATINA,2511,1105,1406,44.00,55.99,1
146708,SV,SUCEAVA,SOLCA,1227,623,604,50.77,49.22,2
150294,SV,SUCEAVA,STRAJA,2212,674,1538,30.47,69.52,1
150310,SV,SUCEAVA,STROIEȘTI,1576,826,750,52.41,47.58,2
150356,SV,SUCEAVA,STULPICANI,2719,1341,1378,49.31,50.68,1
146263,SV,SUCEAVA,SUCEAVA,57096,23511,33585,41.17,58.82,1
150418,SV,SUCEAVA,SUCEVIȚA,1319,568,751,43.06,56.93,1
150524,SV,SUCEAVA,TODIREȘTI,2572,1296,1276,50.38,49.61,2
150588,SV,SUCEAVA,UDEȘTI,3786,2093,1693,55.28,44.71,2
150702,SV,SUCEAVA,ULMA,953,421,532,44.17,55.82,1
150766,SV,SUCEAVA,VADU MOLDOVEI,2382,1514,868,63.56,36.43,2
150891,SV,SUCEAVA,VALEA MOLDOVEI,1624,1078,546,66.37,33.62,2
150935,SV,SUCEAVA,VAMA,2839,917,1922,32.30,67.69,1
146744,SV,SUCEAVA,VATRA DORNEI,9594,4258,5336,44.38,55.61,1
150980,SV,SUCEAVA,VATRA MOLDOVIȚEI,2435,696,1739,28.58,71.41,1
151022,SV,SUCEAVA,VEREȘTI,2679,1483,1196,55.35,44.64,2
151077,SV,SUCEAVA,VICOVU DE JOS,2346,1164,1182,49.61,50.38,1
151095,SV,SUCEAVA,VICOVU DE SUS,5309,2792,2517,52.58,47.41,2
151558,SV,SUCEAVA,VOITINEL,1592,1063,529,66.77,33.22,2
151120,SV,SUCEAVA,VOLOVĂȚ,1879,945,934,50.29,49.70,2
151157,SV,SUCEAVA,VULTUREȘTI,1563,1048,515,67.05,32.94,2
151246,SV,SUCEAVA,ZAMOSTEA,1462,1096,366,74.96,25.03,2
151344,SV,SUCEAVA,ZVORIȘTEA,2671,1890,781,70.76,29.23,2
151790,TR,TELEORMAN,ALEXANDRIA,25575,14647,10928,57.27,42.72,2
152038,TR,TELEORMAN,BĂBĂIȚA,1613,1290,323,79.97,20.02,2
151996,TR,TELEORMAN,BALACI,1161,859,302,73.98,26.01,2
155083,TR,TELEORMAN,BECIU,861,589,272,68.40,31.59,2
155092,TR,TELEORMAN,BEUCA,956,615,341,64.33,35.66,2
152083,TR,TELEORMAN,BLEJEȘTI,2317,1722,595,74.32,25.67,2
152127,TR,TELEORMAN,BOGDANA,1656,1250,406,75.48,24.51,2
152172,TR,TELEORMAN,BOTOROAGA,3221,1877,1344,58.27,41.72,2
152234,TR,TELEORMAN,BRAGADIRU,1837,1476,361,80.34,19.65,2
152252,TR,TELEORMAN,BRÂNCENI,1740,1279,461,73.50,26.49,2
152270,TR,TELEORMAN,BUJORENI,668,460,208,68.86,31.13,2
152314,TR,TELEORMAN,BUJORU,1085,551,534,50.78,49.21,2
152332,TR,TELEORMAN,BUZESCU,2144,861,1283,40.15,59.84,1
152350,TR,TELEORMAN,CĂLINEȘTI,2298,1794,504,78.06,21.93,2
152412,TR,TELEORMAN,CĂLMĂȚUIU,1219,935,284,76.70,23.29,2
152467,TR,TELEORMAN,CĂLMĂȚUIU DE SUS,1452,784,668,53.99,46.00,2
152500,TR,TELEORMAN,CERVENIA,1635,899,736,54.98,45.01,2
152528,TR,TELEORMAN,CIOLĂNEȘTI,1550,1089,461,70.25,29.74,2
151709,TR,TELEORMAN,CIUPERCENI,1096,671,425,61.22,38.77,2
152564,TR,TELEORMAN,CONȚEȘTI,2082,1705,377,81.89,18.10,2
152582,TR,TELEORMAN,COSMEȘTI,1486,454,1032,30.55,69.44,1
152617,TR,TELEORMAN,CRÂNGENI,1573,1140,433,72.47,27.52,2
152662,TR,TELEORMAN,CRÂNGU,844,608,236,72.03,27.96,2
151932,TR,TELEORMAN,CREVENICU,966,647,319,66.97,33.02,2
152724,TR,TELEORMAN,DIDEȘTI,701,381,320,54.35,45.64,2
152760,TR,TELEORMAN,DOBROTEȘTI,2215,1420,795,64.10,35.89,2
155109,TR,TELEORMAN,DRACEA,888,682,206,76.80,23.19,2
152797,TR,TELEORMAN,DRĂCȘENEI,979,698,281,71.29,28.70,2
152902,TR,TELEORMAN,DRĂGĂNEȘTI-VLAȘCA,2249,1510,739,67.14,32.85,2
152868,TR,TELEORMAN,DRĂGĂNEȘTI DE VEDE,1107,601,506,54.29,45.70,2
155118,TR,TELEORMAN,FÂNTÂNELE,1137,685,452,60.24,39.75,2
155127,TR,TELEORMAN,FRĂSINET,1444,1002,442,69.39,30.60,2
152993,TR,TELEORMAN,FRUMOASA,1316,908,408,68.99,31.00,2
152948,TR,TELEORMAN,FURCULEȘTI,1733,1222,511,70.51,29.48,2
153026,TR,TELEORMAN,GĂLĂTENI,1542,1130,412,73.28,26.71,2
153062,TR,TELEORMAN,GRATIA,1767,1432,335,81.04,18.95,2
151736,TR,TELEORMAN,ISLAZ,3029,2039,990,67.31,32.68,2
153106,TR,TELEORMAN,IZVOARELE,1570,893,677,56.87,43.12,2
153124,TR,TELEORMAN,LISA,1348,624,724,46.29,53.70,1
151763,TR,TELEORMAN,LIȚA,1543,1065,478,69.02,30.97,2
153151,TR,TELEORMAN,LUNCA,1550,1135,415,73.22,26.77,2
153240,TR,TELEORMAN,MĂGURA,1884,1295,589,68.73,31.26,2
153277,TR,TELEORMAN,MĂLDĂENI,2382,1610,772,67.59,32.40,2
153339,TR,TELEORMAN,MÂRZĂNEȘTI,2643,1414,1229,53.49,46.50,2
153204,TR,TELEORMAN,MAVRODIN,1305,840,465,64.36,35.63,2
153295,TR,TELEORMAN,MERENI,1571,716,855,45.57,54.42,1
153384,TR,TELEORMAN,MOȘTENI,1079,247,832,22.89,77.10,1
151816,TR,TELEORMAN,NANOV,1951,1143,808,58.58,41.41,2
153400,TR,TELEORMAN,NĂSTURELU,1375,782,593,56.87,43.12,2
153437,TR,TELEORMAN,NECȘEȘTI,691,446,245,64.54,35.45,2
154996,TR,TELEORMAN,NENCIULEȘTI,1344,1004,340,74.70,25.29,2
153473,TR,TELEORMAN,OLTENI,1834,1484,350,80.91,19.08,2
153507,TR,TELEORMAN,ORBEASCA,4138,3170,968,76.60,23.39,2
153543,TR,TELEORMAN,PERETU,3619,1987,1632,54.90,45.09,2
153561,TR,TELEORMAN,PIATRA,1974,1503,471,76.13,23.86,2
153589,TR,TELEORMAN,PIETROȘANI,1306,759,547,58.11,41.88,2
153623,TR,TELEORMAN,PLOPII-SLĂVITEȘTI,1557,797,760,51.18,48.81,2
153605,TR,TELEORMAN,PLOSCA,3115,1421,1694,45.61,54.38,1
153696,TR,TELEORMAN,POENI,1548,940,608,60.72,39.27,2
151834,TR,TELEORMAN,POROSCHIA,3062,2155,907,70.37,29.62,2
155136,TR,TELEORMAN,PURANI,795,534,261,67.16,32.83,2
153829,TR,TELEORMAN,PUTINEIU,1445,1033,412,71.48,28.51,2
153865,TR,TELEORMAN,RĂDOIEȘTI,1389,1137,252,81.85,18.14,2
153909,TR,TELEORMAN,RĂSMIREȘTI,484,343,141,70.86,29.13,2
151870,TR,TELEORMAN,ROȘIORI DE VEDE,14608,8850,5758,60.58,39.41,2
153972,TR,TELEORMAN,SĂCENI,798,605,193,75.81,24.18,2
155145,TR,TELEORMAN,SAELELE,1583,1248,335,78.83,21.16,2
153936,TR,TELEORMAN,SALCIA,1679,1293,386,77.01,22.98,2
154308,TR,TELEORMAN,SÂRBENI,873,645,228,73.88,26.11,2
154013,TR,TELEORMAN,SCRIOAȘTEA,2267,1610,657,71.01,28.98,2
154068,TR,TELEORMAN,SCURTU MARE,1082,799,283,73.84,26.15,2
154139,TR,TELEORMAN,SEACA,1050,635,415,60.47,39.52,2
154184,TR,TELEORMAN,SEGARCEA-VALE,1885,1362,523,72.25,27.74,2
154166,TR,TELEORMAN,SFINȚEȘTI,763,367,396,48.09,51.90,1
154228,TR,TELEORMAN,SILIȘTEA,1427,612,815,42.88,57.11,1
154282,TR,TELEORMAN,SILIȘTEA-GUMEȘTI,1244,818,426,65.75,34.24,2
154344,TR,TELEORMAN,SLOBOZIA MÂNDRA,1182,924,258,78.17,21.82,2
154380,TR,TELEORMAN,SMÂRDIOASA,1315,886,429,67.37,32.62,2
154415,TR,TELEORMAN,STEJARU,1541,1055,486,68.46,31.53,2
154497,TR,TELEORMAN,ȘTOROBĂNEASA,1798,1362,436,75.75,24.24,2
154460,TR,TELEORMAN,SUHAIA,1520,619,901,40.72,59.27,1
154521,TR,TELEORMAN,TALPA,1328,1036,292,78.01,21.98,2
154585,TR,TELEORMAN,TĂTĂRĂȘTII DE JOS,1696,1123,573,66.21,33.78,2
154665,TR,TELEORMAN,TĂTĂRĂȘTII DE SUS,1658,814,844,49.09,50.90,1
154834,TR,TELEORMAN,ȚIGĂNEȘTI,2903,2106,797,72.54,27.45,2
154736,TR,TELEORMAN,TRAIAN,1057,748,309,70.76,29.23,2
154754,TR,TELEORMAN,TRIVALEA-MOȘTENI,1412,747,665,52.90,47.09,2
154790,TR,TELEORMAN,TROIANUL,1744,992,752,56.88,43.11,2
151683,TR,TELEORMAN,TURNU MAGURELE,13452,7873,5579,58.52,41.47,2
155154,TR,TELEORMAN,UDA-CLOCOCIOV,1022,738,284,72.21,27.78,2
154932,TR,TELEORMAN,VÂRTOAPE,1750,753,997,43.02,56.97,1
154852,TR,TELEORMAN,VEDEA,1565,1387,178,88.62,11.37,2
151905,TR,TELEORMAN,VIDELE,6542,3514,3028,53.71,46.28,2
154914,TR,TELEORMAN,VIIȘOARA,1218,567,651,46.55,53.44,1
153776,TR,TELEORMAN,VITĂNEȘTI,1967,1506,461,76.56,23.43,2
154978,TR,TELEORMAN,ZÂMBREASCA,917,671,246,73.17,26.82,2
151978,TR,TELEORMAN,ZIMNICEA,7663,5165,2498,67.40,32.59,2
155546,TM,TIMIȘ,BALINȚ,983,383,600,38.96,61.03,1
155591,TM,TIMIȘ,BANLOC,1293,639,654,49.41,50.58,1
155662,TM,TIMIȘ,BARA,312,201,111,64.42,35.57,2
155957,TM,TIMIȘ,BÂRNA,819,455,364,55.55,44.44,2
155724,TM,TIMIȘ,BEBA VECHE,796,327,469,41.08,58.91,1
155760,TM,TIMIȘ,BECICHERECU MIC,1715,715,1000,41.69,58.30,1
155797,TM,TIMIȘ,BELINȚ,1540,511,1029,33.18,66.81,1
155840,TM,TIMIȘ,BETHAUSEN,1537,777,760,50.55,49.44,2
155911,TM,TIMIȘ,BILED,1947,666,1281,34.20,65.79,1
159366,TM,TIMIȘ,BIRDA,1113,616,497,55.34,44.65,2
156035,TM,TIMIȘ,BOGDA,338,169,169,50.00,50.00,2
156106,TM,TIMIȘ,BOLDUR,1433,580,853,40.47,59.52,1
156151,TM,TIMIȘ,BRESTOVĂȚ,412,153,259,37.13,62.86,1
159516,TM,TIMIȘ,BUCOVĂȚ,1091,353,738,32.35,67.64,1
155403,TM,TIMIȘ,BUZIAȘ,4143,1853,2290,44.72,55.27,1
156213,TM,TIMIȘ,CĂRPINIȘ,2042,651,1391,31.88,68.11,1
156259,TM,TIMIȘ,CENAD,1663,491,1172,29.52,70.47,1
156277,TM,TIMIȘ,CENEI,1506,426,1080,28.28,71.71,1
159375,TM,TIMIȘ,CHECEA,729,248,481,34.01,65.98,1
156311,TM,TIMIȘ,CHEVEREȘU MARE,1220,592,628,48.52,51.47,1
156357,TM,TIMIȘ,CIACOVA,2525,709,1816,28.07,71.92,1
156437,TM,TIMIȘ,COMLOȘU MARE,2273,1254,1019,55.16,44.83,2
156473,TM,TIMIȘ,COȘTEIU,1976,726,1250,36.74,63.25,1
156534,TM,TIMIȘ,CRICIOVA,1113,532,581,47.79,52.20,1
156589,TM,TIMIȘ,CURTEA,713,404,309,56.66,43.33,2
156623,TM,TIMIȘ,DAROVA,1328,368,960,27.71,72.28,1
156669,TM,TIMIȘ,DENTA,1663,749,914,45.03,54.96,1
155458,TM,TIMIȘ,DETA,3257,1014,2243,31.13,68.86,1
159384,TM,TIMIȘ,DUDEȘTII NOI,1398,353,1045,25.25,74.74,1
156712,TM,TIMIȘ,DUDEȘTII VECHI,1909,410,1499,21.47,78.52,1
156767,TM,TIMIȘ,DUMBRAVA,1260,524,736,41.58,58.41,1
155261,TM,TIMIȘ,DUMBRĂVIȚA,5053,1331,3722,26.34,73.65,1
156801,TM,TIMIȘ,FĂGET,4001,1889,2112,47.21,52.78,1
156927,TM,TIMIȘ,FÂRDEA,1070,445,625,41.58,58.41,1
159393,TM,TIMIȘ,FIBIȘ,923,298,625,32.28,67.71,1
157004,TM,TIMIȘ,FOENI,792,223,569,28.15,71.84,1
157086,TM,TIMIȘ,GĂTAIA,3150,1159,1991,36.79,63.20,1
157031,TM,TIMIȘ,GAVOJDIA,1426,503,923,35.27,64.72,1
159400,TM,TIMIȘ,GHILAD,952,288,664,30.25,69.74,1
155289,TM,TIMIȘ,GHIRODA,3881,1267,2614,32.64,67.35,1
157193,TM,TIMIȘ,GHIZELA,672,324,348,48.21,51.78,1
157246,TM,TIMIȘ,GIARMATA,3383,1040,2343,30.74,69.25,1
157273,TM,TIMIȘ,GIERA,664,229,435,34.48,65.51,1
155314,TM,TIMIȘ,GIROC,6148,1883,4265,30.62,69.37,1
157317,TM,TIMIȘ,GIULVĂZ,1472,554,918,37.63,62.36,1
159419,TM,TIMIȘ,GOTTLOB,988,212,776,21.45,78.54,1
159428,TM,TIMIȘ,IECEA MARE,1251,570,681,45.56,54.43,1
157362,TM,TIMIȘ,JAMU MARE,1485,639,846,43.03,56.96,1
157424,TM,TIMIȘ,JEBEL,2323,898,1425,38.65,61.34,1
155494,TM,TIMIȘ,JIMBOLIA,5099,1423,3676,27.90,72.09,1
157451,TM,TIMIȘ,LENAUHEIM,2265,604,1661,26.66,73.33,1
157497,TM,TIMIȘ,LIEBLING,1876,599,1277,31.92,68.07,1
159491,TM,TIMIȘ,LIVEZILE,673,233,440,34.62,65.37,1
157530,TM,TIMIȘ,LOVRIN,1540,410,1130,26.62,73.37,1
155350,TM,TIMIȘ,LUGOJ,22881,8471,14410,37.02,62.97,1
157736,TM,TIMIȘ,MĂNĂȘTIUR,844,351,493,41.58,58.41,1
157585,TM,TIMIȘ,MARGINA,1231,718,513,58.32,41.67,2
157683,TM,TIMIȘ,MAȘLOC,1180,479,701,40.59,59.40,1
157781,TM,TIMIȘ,MORAVIȚA,1242,713,529,57.40,42.59,2
157834,TM,TIMIȘ,MOȘNIȚA NOUĂ,4444,1191,3253,26.80,73.19,1
157898,TM,TIMIȘ,NĂDRAG,1466,704,762,48.02,51.97,1
157923,TM,TIMIȘ,NIȚCHIDORF,842,325,517,38.59,61.40,1
157969,TM,TIMIȘ,OHABA LUNGĂ,683,379,304,55.49,44.50,2
158010,TM,TIMIȘ,ORȚIȘOARA,2175,674,1501,30.98,69.01,1
159525,TM,TIMIȘ,OTELEC,745,145,600,19.46,80.53,1
159446,TM,TIMIȘ,PĂDURENI,1012,288,724,28.45,71.54,1
159437,TM,TIMIȘ,PARȚA,1221,518,703,42.42,57.57,1
158065,TM,TIMIȘ,PECIU NOU,2654,715,1939,26.94,73.05,1
158109,TM,TIMIȘ,PERIAM,2251,913,1338,40.55,59.44,1
159507,TM,TIMIȘ,PESAC,983,496,487,50.45,49.54,2
158136,TM,TIMIȘ,PIETROASA,683,445,238,65.15,34.84,2
158181,TM,TIMIȘ,PIȘCHIA,1641,535,1106,32.60,67.39,1
158243,TM,TIMIȘ,RACOVIȚA,1830,875,955,47.81,52.18,1
158314,TM,TIMIȘ,RECAȘ,4665,1821,2844,39.03,60.96,1
158396,TM,TIMIȘ,REMETEA MARE,1709,672,1037,39.32,60.67,1
158564,TM,TIMIȘ,SĂCĂLAZ,4035,1224,2811,30.33,69.66,1
158449,TM,TIMIȘ,SACOȘU TURCESC,1950,703,1247,36.05,63.94,1
158779,TM,TIMIȘ,ȘAG,1875,582,1293,31.04,68.96,1
158653,TM,TIMIȘ,SÂNANDREI,3423,1210,2213,35.34,64.65,1
159464,TM,TIMIȘ,ȘANDRA,1420,557,863,39.22,60.77,1
158699,TM,TIMIȘ,SÂNMIHAIU ROMÂN,3748,867,2881,23.13,76.86,1
155528,TM,TIMIȘ,SÂNNICOLAU MARE,6684,2144,4540,32.07,67.92,1
158733,TM,TIMIȘ,SÂNPETRU MARE,1333,477,856,35.78,64.21,1
159455,TM,TIMIȘ,SARAVALE,1204,425,779,35.29,64.70,1
158528,TM,TIMIȘ,SATCHINEZ,2229,573,1656,25.70,74.29,1
158608,TM,TIMIȘ,SECAȘ,287,138,149,48.08,51.91,1
158804,TM,TIMIȘ,ȘTIUCA,883,223,660,25.25,74.74,1
158859,TM,TIMIȘ,TEREMIA MARE,1708,588,1120,34.42,65.57,1
155243,TM,TIMIȘ,TIMIȘOARA,185832,55766,130066,30.00,69.99,1
158895,TM,TIMIȘ,TOMEȘTI,1203,583,620,48.46,51.53,1
159473,TM,TIMIȘ,TOMNATIC,1440,636,804,44.16,55.83,1
158966,TM,TIMIȘ,TOPOLOVĂȚU MARE,1427,394,1033,27.61,72.38,1
159035,TM,TIMIȘ,TORMAC,1266,413,853,32.62,67.37,1
159071,TM,TIMIȘ,TRAIAN VUIA,1116,505,611,45.25,54.74,1
159142,TM,TIMIȘ,UIVAR,1247,422,825,33.84,66.15,1
159482,TM,TIMIȘ,VALCANI,718,324,394,45.12,54.87,1
159213,TM,TIMIȘ,VARIAȘ,3120,1630,1490,52.24,47.75,2
159259,TM,TIMIȘ,VICTOR VLAD DELAMARINA,1518,722,796,47.56,52.43,1
159339,TM,TIMIȘ,VOITEG,1184,453,731,38.26,61.73,1
159650,TL,TULCEA,BABADAG,4255,2215,2040,52.05,47.94,2
159785,TL,TULCEA,BAIA,2254,1152,1102,51.10,48.89,2
159847,TL,TULCEA,BEIDAUD,762,452,310,59.31,40.68,2
161552,TL,TULCEA,BEȘTEPE,801,447,354,55.80,44.19,2
159883,TL,TULCEA,C.A. ROSETTI,423,118,305,27.89,72.10,1
159945,TL,TULCEA,CARCALIU,1038,525,513,50.57,49.42,2
159963,TL,TULCEA,CASIMCEA,1299,816,483,62.81,37.18,2
160092,TL,TULCEA,CEAMURLIA DE JOS,1174,504,670,42.93,57.06,1
160047,TL,TULCEA,CEATALCHIOI,384,161,223,41.92,58.07,1
160127,TL,TULCEA,CERNA,1776,1089,687,61.31,38.68,2
160172,TL,TULCEA,CHILIA VECHE,884,385,499,43.55,56.44,1
160225,TL,TULCEA,CIUCUROVA,984,521,463,52.94,47.05,2
160261,TL,TULCEA,CRIȘAN,954,344,610,36.05,63.94,1
160305,TL,TULCEA,DĂENI,978,471,507,48.15,51.84,1
160323,TL,TULCEA,DOROBANȚU,704,465,239,66.05,33.94,2
160387,TL,TULCEA,FRECĂȚEI,1968,1087,881,55.23,44.76,2
160430,TL,TULCEA,GRECI,2122,1021,1101,48.11,51.88,1
160458,TL,TULCEA,GRINDU,806,327,479,40.57,59.42,1
160476,TL,TULCEA,HAMCEARCA,714,300,414,42.01,57.98,1
160528,TL,TULCEA,HORIA,846,543,303,64.18,35.81,2
161525,TL,TULCEA,I.C.BRĂTIANU,907,400,507,44.10,55.89,1
159687,TL,TULCEA,ISACCEA,2566,1151,1415,44.85,55.14,1
160564,TL,TULCEA,IZVOARELE,1082,587,495,54.25,45.74,2
160617,TL,TULCEA,JIJILA,2680,1187,1493,44.29,55.70,1
160644,TL,TULCEA,JURILOVCA,2314,1478,836,63.87,36.12,2
160680,TL,TULCEA,LUNCAVIȚA,1800,877,923,48.72,51.27,1
159730,TL,TULCEA,MĂCIN,4463,1943,2520,43.53,56.46,1
160724,TL,TULCEA,MAHMUDIA,1391,650,741,46.72,53.27,1
160779,TL,TULCEA,MALIUC,514,211,303,41.05,58.94,1
160831,TL,TULCEA,MIHAI BRAVU,1158,793,365,68.48,31.51,2
160877,TL,TULCEA,MIHAIL KOGĂLNICEANU,1453,854,599,58.77,41.22,2
160911,TL,TULCEA,MURIGHIOL,2004,726,1278,36.22,63.77,1
160993,TL,TULCEA,NALBANT,952,574,378,60.29,39.70,2
161035,TL,TULCEA,NICULIȚEL,2057,1119,938,54.39,45.60,2
161053,TL,TULCEA,NUFĂRU,1444,790,654,54.70,45.29,2
161106,TL,TULCEA,OSTROV,861,441,420,51.21,48.78,2
161133,TL,TULCEA,PARDINA,238,104,134,43.69,56.30,1
161151,TL,TULCEA,PECENEAGA,939,541,398,57.61,42.38,2
161179,TL,TULCEA,SARICHIOI,3281,1458,1823,44.43,55.56,1
161231,TL,TULCEA,SFÂNTU GHEORGHE,453,211,242,46.57,53.42,1
161259,TL,TULCEA,SLAVA CERCHEZĂ,874,441,433,50.45,49.54,2
161286,TL,TULCEA,SMÂRDAN,578,134,444,23.18,76.81,1
161302,TL,TULCEA,SOMOVA,2224,1013,1211,45.54,54.45,1
161348,TL,TULCEA,STEJARU,747,418,329,55.95,44.04,2
159767,TL,TULCEA,SULINA,2160,885,1275,40.97,59.02,1
161384,TL,TULCEA,TOPOLOG,2192,1382,810,63.04,36.95,2
159614,TL,TULCEA,TULCEA,42808,17961,24847,41.95,58.04,1
161464,TL,TULCEA,TURCOAIA,1764,1028,736,58.27,41.72,2
161543,TL,TULCEA,VĂCĂRENI,1095,538,557,49.13,50.86,1
161482,TL,TULCEA,VALEA NUCARILOR,1753,991,762,56.53,43.46,2
161561,TL,TULCEA,VALEA TEILOR,645,419,226,64.96,35.03,2
168229,VL,VÂLCEA,ALUNU,2136,1063,1073,49.76,50.23,1
168309,VL,VÂLCEA,AMĂRĂȘTI,998,526,472,52.70,47.29,2
168372,VL,VÂLCEA,BĂBENI,4799,2528,2271,52.67,47.32,2
167641,VL,VÂLCEA,BĂILE GOVORA,2112,987,1125,46.73,53.26,1
167696,VL,VÂLCEA,BĂILE OLĂNEȘTI,3286,1930,1356,58.73,41.26,2
168452,VL,VÂLCEA,BĂLCEȘTI,2897,1837,1060,63.41,36.58,2
168559,VL,VÂLCEA,BĂRBĂTEȘTI,1951,1192,759,61.09,38.90,2
168602,VL,VÂLCEA,BERBEȘTI,2601,1173,1428,45.09,54.90,1
168675,VL,VÂLCEA,BERISLĂVEȘTI,1633,788,845,48.25,51.74,1
168755,VL,VÂLCEA,BOIȘOARA,700,230,470,32.85,67.14,1
167794,VL,VÂLCEA,BREZOI,3310,1458,1852,44.04,55.95,1
168791,VL,VÂLCEA,BUDEȘTI,3142,1242,1900,39.52,60.47,1
168880,VL,VÂLCEA,BUJORENI,2429,1058,1371,43.55,56.44,1
168960,VL,VÂLCEA,BUNEȘTI,1463,972,491,66.43,33.56,2
169119,VL,VÂLCEA,CÂINENI,1289,409,880,31.73,68.26,1
167909,VL,VÂLCEA,CĂLIMĂNEȘTI,5757,2532,3225,43.98,56.01,1
169039,VL,VÂLCEA,CERNIȘOARA,2072,1389,683,67.03,32.96,2
169182,VL,VÂLCEA,COPĂCENI,1348,785,563,58.23,41.76,2
169253,VL,VÂLCEA,COSTEȘTI,1941,1156,785,59.55,40.44,2
169306,VL,VÂLCEA,CREȚENI,1307,761,546,58.22,41.77,2
169351,VL,VÂLCEA,DĂEȘTI,1820,616,1204,33.84,66.15,1
169404,VL,VÂLCEA,DĂNICEI,1148,742,406,64.63,35.36,2
174502,VL,VÂLCEA,DICULEȘTI,1030,608,422,59.02,40.97,2
167981,VL,VÂLCEA,DRĂGĂȘANI,9940,5371,4569,54.03,45.96,2
169547,VL,VÂLCEA,DRĂGOEȘTI,1189,774,415,65.09,34.90,2
169681,VL,VÂLCEA,FÂRTĂȚEȘTI,2067,1458,609,70.53,29.46,2
169583,VL,VÂLCEA,FĂUREȘTI,776,402,374,51.80,48.19,2
169896,VL,VÂLCEA,FRÂNCEȘTI,2612,1602,1010,61.33,38.66,2
169994,VL,VÂLCEA,GALICEA,2377,1221,1156,51.36,48.63,2
170097,VL,VÂLCEA,GHIOROIU,941,615,326,65.35,34.64,2
170168,VL,VÂLCEA,GLĂVILE,1021,650,371,63.66,36.33,2
170220,VL,VÂLCEA,GOLEȘTI,1486,709,777,47.71,52.28,1
170346,VL,VÂLCEA,GRĂDIȘTEA,1381,571,810,41.34,58.65,1
170444,VL,VÂLCEA,GUȘOENI,917,591,326,64.44,35.55,2
168041,VL,VÂLCEA,HOREZU,4074,1915,2159,47.00,52.99,1
170514,VL,VÂLCEA,IONEȘTI,2087,1168,919,55.96,44.03,2
174511,VL,VÂLCEA,LĂCUSTENI,790,476,314,60.25,39.74,2
170685,VL,VÂLCEA,LĂDEȘTI,1201,690,511,57.45,42.54,2
170612,VL,VÂLCEA,LALOȘU,1071,632,439,59.01,40.98,2
170792,VL,VÂLCEA,LĂPUȘATA,1131,591,540,52.25,47.74,2
170872,VL,VÂLCEA,LIVEZI,1115,689,426,61.79,38.20,2
170952,VL,VÂLCEA,LUNGEȘTI,1704,1027,677,60.26,39.73,2
171101,VL,VÂLCEA,MĂCIUCA,1658,559,1099,33.71,66.28,1
171209,VL,VÂLCEA,MĂDULARI,870,518,352,59.54,40.45,2
171021,VL,VÂLCEA,MALAIA,1209,518,691,42.84,57.15,1
171272,VL,VÂLCEA,MĂLDĂREȘTI,1151,685,466,59.51,40.48,2
171067,VL,VÂLCEA,MATEEȘTI,1778,1009,769,56.74,43.25,2
171325,VL,VÂLCEA,MIHĂEȘTI,3719,2047,1672,55.04,44.95,2
171469,VL,VÂLCEA,MILCOIU,813,366,447,45.01,54.98,1
174520,VL,VÂLCEA,MITROFANI,566,259,307,45.75,54.24,1
171539,VL,VÂLCEA,MUEREASCA,1207,430,777,35.62,64.37,1
171628,VL,VÂLCEA,NICOLAE BĂLCESCU,2040,1294,746,63.43,36.56,2
168130,VL,VÂLCEA,OCNELE MARI,1948,1059,889,54.36,45.63,2
171806,VL,VÂLCEA,OLANU,1776,895,881,50.39,49.60,2
171879,VL,VÂLCEA,ORLEȘTI,1739,804,935,46.23,53.76,1
171931,VL,VÂLCEA,OTEȘANI,1570,757,813,48.21,51.78,1
171995,VL,VÂLCEA,PĂUȘEȘTI,1517,878,639,57.87,42.12,2
172082,VL,VÂLCEA,PĂUSEȘTI-MĂGLAȘI,2188,955,1233,43.64,56.35,1
172153,VL,VÂLCEA,PERIȘANI,1284,418,866,32.55,67.44,1
172279,VL,VÂLCEA,PESCEANA,1002,646,356,64.47,35.52,2
172340,VL,VÂLCEA,PIETRARI,1786,890,896,49.83,50.16,1
172377,VL,VÂLCEA,POPEȘTI,1771,1044,727,58.94,41.05,2
172457,VL,VÂLCEA,PRUNDENI,2288,1533,755,67.00,32.99,2
172509,VL,VÂLCEA,RACOVIȚA,932,309,623,33.15,66.84,1
167473,VL,VÂLCEA,RÂMNICU VÂLCEA,59610,25834,33776,43.33,56.66,1
172581,VL,VÂLCEA,ROEȘTI,1172,759,413,64.76,35.23,2
172698,VL,VÂLCEA,ROȘIILE,1308,762,546,58.25,41.74,2
172812,VL,VÂLCEA,RUNCU,564,267,297,47.34,52.65,1
172894,VL,VÂLCEA,SĂLĂTRUCEL,1061,334,727,31.47,68.52,1
172947,VL,VÂLCEA,SCUNDU,1236,895,341,72.41,27.58,2
172992,VL,VÂLCEA,SINEȘTI,1310,630,680,48.09,51.90,1
173686,VL,VÂLCEA,ȘIRINEASA,1255,721,534,57.45,42.54,2
173061,VL,VÂLCEA,SLĂTIOARA,1871,1261,610,67.39,32.60,2
173132,VL,VÂLCEA,STĂNEȘTI,728,324,404,44.50,55.49,1
173748,VL,VÂLCEA,ȘTEFĂNEȘTI,1892,1262,630,66.70,33.29,2
173230,VL,VÂLCEA,STOENEȘTI,2062,1304,758,63.23,36.76,2
173374,VL,VÂLCEA,STOILEȘTI,2096,1153,943,55.00,44.99,2
173533,VL,VÂLCEA,STROEȘTI,1485,885,600,59.59,40.40,2
173793,VL,VÂLCEA,ȘUȘANI,1805,1217,588,67.42,32.57,2
173597,VL,VÂLCEA,SUTEȘTI,1088,527,561,48.43,51.56,1
173855,VL,VÂLCEA,TETOIU,1436,793,643,55.22,44.77,2
174496,VL,VÂLCEA,TITEȘTI,570,171,399,30.00,70.00,1
173935,VL,VÂLCEA,TOMȘANI,2352,1453,899,61.77,38.22,2
174021,VL,VÂLCEA,VAIDEENI,2194,1227,967,55.92,44.07,2
174085,VL,VÂLCEA,VALEA MARE,1436,837,599,58.28,41.71,2
174156,VL,VÂLCEA,VLĂDEȘTI,1830,895,935,48.90,51.09,1
174218,VL,VÂLCEA,VOICEȘTI,976,640,336,65.57,34.42,2
174254,VL,VÂLCEA,VOINEASA,963,369,594,38.31,61.68,1
174290,VL,VÂLCEA,ZĂTRENI,1301,740,561,56.87,43.12,2
162014,VS,VASLUI,ALBEȘTI,1318,768,550,58.27,41.72,2
162069,VS,VASLUI,ALEXANDRU VLAHUȚĂ,948,510,438,53.79,46.20,2
162149,VS,VASLUI,ARSURA,799,516,283,64.58,35.41,2
162327,VS,VASLUI,BĂCANI,1333,792,541,59.41,40.58,2
162381,VS,VASLUI,BĂCEȘTI,1506,1073,433,71.24,28.75,2
162452,VS,VASLUI,BĂLTENI,774,577,197,74.54,25.45,2
162194,VS,VASLUI,BANCA,2713,1703,1010,62.77,37.22,2
161794,VS,VASLUI,BÂRLAD,31766,15760,16006,49.61,50.38,1
162498,VS,VASLUI,BEREZENI,2444,1695,749,69.35,30.64,2
162559,VS,VASLUI,BLĂGEȘTI,717,493,224,68.75,31.24,2
162595,VS,VASLUI,BOGDANA,770,392,378,50.90,49.09,2
162693,VS,VASLUI,BOGDĂNEȘTI,1668,1264,404,75.77,24.22,2
162791,VS,VASLUI,BOGDĂNIȚA,661,438,223,66.26,33.73,2
162871,VS,VASLUI,BOȚEȘTI,1063,738,325,69.42,30.57,2
162924,VS,VASLUI,BUNEȘTI-AVEREȘTI,1279,882,397,68.96,31.03,2
167268,VS,VASLUI,CIOCANI,662,321,341,48.48,51.51,1
163002,VS,VASLUI,CODĂEȘTI,1777,1092,685,61.45,38.54,2
163057,VS,VASLUI,COROIEȘTI,1038,833,205,80.25,19.74,2
163137,VS,VASLUI,COSTEȘTI,1299,751,548,57.81,42.18,2
167277,VS,VASLUI,COZMEȘTI,936,719,217,76.81,23.18,2
163208,VS,VASLUI,CREȚEȘTI,1011,677,334,66.96,33.03,2
163253,VS,VASLUI,DĂNEȘTI,766,537,229,70.10,29.89,2
163324,VS,VASLUI,DELENI,1045,599,446,57.32,42.67,2
163379,VS,VASLUI,DELEȘTI,1025,629,396,61.36,38.63,2
164277,VS,VASLUI,DIMITRIE CANTEMIR,1118,766,352,68.51,31.48,2
167286,VS,VASLUI,DODEȘTI,836,545,291,65.19,34.80,2
163486,VS,VASLUI,DRAGOMIREȘTI,1855,1247,608,67.22,32.77,2
163618,VS,VASLUI,DRÂNCENI,1979,1138,841,57.50,42.49,2
163681,VS,VASLUI,DUDA-EPURENI,1805,1070,735,59.27,40.72,2
163734,VS,VASLUI,DUMEȘTI,1470,1096,374,74.55,25.44,2
163789,VS,VASLUI,EPURENI,1200,770,430,64.16,35.83,2
163832,VS,VASLUI,FĂLCIU,2410,1497,913,62.11,37.88,2
167295,VS,VASLUI,FEREȘTI,751,567,184,75.49,24.50,2
167231,VS,VASLUI,FRUNTIȘENI,739,473,266,64.00,35.99,2
163903,VS,VASLUI,GĂGEȘTI,961,620,341,64.51,35.48,2
164062,VS,VASLUI,GÂRCENI,1168,844,324,72.26,27.73,2
163967,VS,VASLUI,GHERGHEȘTI,1203,633,570,52.61,47.38,2
164133,VS,VASLUI,GRIVIȚA,1613,854,759,52.94,47.05,2
164197,VS,VASLUI,HOCENI,1522,1250,272,82.12,17.87,2
161829,VS,VASLUI,HUȘI,13372,7442,5930,55.65,44.34,2
164339,VS,VASLUI,IANA,1793,1187,606,66.20,33.79,2
167222,VS,VASLUI,IBĂNEȘTI,932,751,181,80.57,19.42,2
164393,VS,VASLUI,IVĂNEȘTI,1882,1208,674,64.18,35.81,2
164543,VS,VASLUI,IVEȘTI,1137,672,465,59.10,40.89,2
164598,VS,VASLUI,LAZA,1378,875,503,63.49,36.50,2
164687,VS,VASLUI,LIPOVĂȚ,1911,1366,545,71.48,28.51,2
164749,VS,VASLUI,LUNCA BANULUI,1476,909,567,61.58,38.41,2
164829,VS,VASLUI,MĂLUȘTENI,1233,813,420,65.93,34.06,2
164892,VS,VASLUI,MICLEȘTI,1200,864,336,72.00,28.00,2
164936,VS,VASLUI,MUNTENII DE JOS,1906,1165,741,61.12,38.87,2
167302,VS,VASLUI,MUNTENII DE SUS,1363,758,605,55.61,44.38,2
164981,VS,VASLUI,MURGENI,2893,1943,950,67.16,32.83,2
161856,VS,VASLUI,NEGREȘTI,4324,2595,1729,60.01,39.98,2
165069,VS,VASLUI,OLTENEȘTI,1175,803,372,68.34,31.65,2
165130,VS,VASLUI,OȘEȘTI,1266,811,455,64.06,35.93,2
165185,VS,VASLUI,PĂDURENI,1698,1254,444,73.85,26.14,2
165274,VS,VASLUI,PERIENI,1618,1099,519,67.92,32.07,2
167311,VS,VASLUI,POCHIDIA,950,519,431,54.63,45.36,2
165416,VS,VASLUI,POGANA,1211,678,533,55.98,44.01,2
167259,VS,VASLUI,POGONEȘTI,897,611,286,68.11,31.88,2
165336,VS,VASLUI,POIENEȘTI,873,476,397,54.52,45.47,2
165470,VS,VASLUI,PUIEȘTI,2119,1466,653,69.18,30.81,2
165611,VS,VASLUI,PUNGEȘTI,1462,677,785,46.30,53.69,1
167320,VS,VASLUI,PUȘCAȘI,1466,937,529,63.91,36.08,2
167240,VS,VASLUI,RAFAILA,762,616,146,80.83,19.16,2
165719,VS,VASLUI,REBRICEA,1493,1097,396,73.47,26.52,2
165817,VS,VASLUI,ROȘIEȘTI,1614,993,621,61.52,38.47,2
165899,VS,VASLUI,SOLEȘTI,1695,1167,528,68.84,31.15,2
165979,VS,VASLUI,STĂNILEȘTI,2269,1237,1032,54.51,45.48,2
166057,VS,VASLUI,ȘTEFAN CEL MARE,1733,1432,301,82.63,17.36,2
166137,VS,VASLUI,ȘULETEA,1038,497,541,47.88,52.11,1
166235,VS,VASLUI,TĂCUTA,1496,837,659,55.94,44.05,2
166182,VS,VASLUI,TANACU,927,691,236,74.54,25.45,2
166315,VS,VASLUI,TĂTĂRĂNI,874,575,299,65.78,34.21,2
166413,VS,VASLUI,TODIREȘTI,1443,1035,408,71.72,28.27,2
166529,VS,VASLUI,TUTOVA,1775,1096,679,61.74,38.25,2
166636,VS,VASLUI,VĂLENI,1665,839,826,50.39,49.60,2
161945,VS,VASLUI,VASLUI,32590,16887,15703,51.81,48.18,2
166672,VS,VASLUI,VETRIȘOAIA,1348,935,413,69.36,30.63,2
166707,VS,VASLUI,VIIȘOARA,861,660,201,76.65,23.34,2
166770,VS,VASLUI,VINDEREI,1587,997,590,62.82,37.17,2
166869,VS,VASLUI,VOINEȘTI,1576,1198,378,76.01,23.98,2
166985,VS,VASLUI,VULTUREȘTI,1003,674,329,67.19,32.80,2
167035,VS,VASLUI,VUTCANI,1072,820,252,76.49,23.50,2
167071,VS,VASLUI,ZĂPODENI,2055,1540,515,74.93,25.06,2
167179,VS,VASLUI,ZORLENI,3922,2366,1556,60.32,39.67,2
174860,VN,VRANCEA,ADJUD,8387,4343,4044,51.78,48.21,2
175126,VN,VRANCEA,ANDREIAȘU DE JOS,947,519,428,54.80,45.19,2
175206,VN,VRANCEA,BĂLEȘTI,1015,668,347,65.81,34.18,2
175224,VN,VRANCEA,BÂRSEȘTI,789,439,350,55.64,44.35,2
178929,VN,VRANCEA,BILIEȘTI,1149,475,674,41.34,58.65,1
175260,VN,VRANCEA,BOGHEȘTI,923,680,243,73.67,26.32,2
175368,VN,VRANCEA,BOLOTEȘTI,2369,1340,1029,56.56,43.43,2
175439,VN,VRANCEA,BORDEȘTI,978,567,411,57.97,42.02,2
175466,VN,VRANCEA,BROȘTENI,1078,613,465,56.86,43.13,2
174780,VN,VRANCEA,CÂMPINEANCA,1987,931,1056,46.85,53.14,1
175670,VN,VRANCEA,CÂMPURI,1810,1143,667,63.14,36.85,2
175732,VN,VRANCEA,CÂRLIGELE,1568,1144,424,72.95,27.04,2
175509,VN,VRANCEA,CHIOJDENI,1179,592,587,50.21,49.78,2
175590,VN,VRANCEA,CIORĂȘTI,1927,840,1087,43.59,56.40,1
175787,VN,VRANCEA,CORBIȚA,987,743,244,75.27,24.72,2
175885,VN,VRANCEA,COTEȘTI,2430,1318,1112,54.23,45.76,2
175938,VN,VRANCEA,DUMBRĂVENI,2285,1295,990,56.67,43.32,2
175983,VN,VRANCEA,DUMITREȘTI,2705,1621,1084,59.92,40.07,2
176150,VN,VRANCEA,FITIONEȘTI,1350,614,736,45.48,54.51,1
174744,VN,VRANCEA,FOCȘANI,46114,20976,25138,45.48,54.51,1
176212,VN,VRANCEA,GAROAFA,2329,1129,1200,48.47,51.52,1
174824,VN,VRANCEA,GOLEȘTI,2239,1150,1089,51.36,48.63,2
178938,VN,VRANCEA,GOLOGANU,1595,1039,556,65.14,34.85,2
176301,VN,VRANCEA,GUGEȘTI,3226,1947,1279,60.35,39.64,2
176338,VN,VRANCEA,GURA CALIȚEI,1287,790,497,61.38,38.61,2
176445,VN,VRANCEA,HOMOCEA,2597,1459,1138,56.18,43.81,2
176506,VN,VRANCEA,JARIȘTEA,2241,845,1396,37.70,62.29,1
176551,VN,VRANCEA,JITIA,799,365,434,45.68,54.31,1
176613,VN,VRANCEA,MĂICĂNEȘTI,2680,1975,705,73.69,26.30,2
174922,VN,VRANCEA,MĂRĂȘEȘTI,5563,3534,2029,63.52,36.47,2
176686,VN,VRANCEA,MERA,1731,973,758,56.21,43.78,2
176748,VN,VRANCEA,MILCOVUL,2088,1058,1030,50.67,49.32,2
176793,VN,VRANCEA,MOVILIȚA,1730,770,960,44.50,55.49,1
176855,VN,VRANCEA,NĂNEȘTI,1268,721,547,56.86,43.13,2
176891,VN,VRANCEA,NĂRUJA,937,537,400,57.31,42.68,2
178885,VN,VRANCEA,NEGRILEȘTI,787,495,292,62.89,37.10,2
176944,VN,VRANCEA,NEREJU,1982,1301,681,65.64,34.35,2
177003,VN,VRANCEA,NISTOREȘTI,1127,780,347,69.21,30.78,2
178947,VN,VRANCEA,OBREJIȚA,824,502,322,60.92,39.07,2
175019,VN,VRANCEA,ODOBEȘTI,4736,2725,2011,57.53,42.46,2
177101,VN,VRANCEA,PALTIN,907,561,346,61.85,38.14,2
175055,VN,VRANCEA,PANCIU,4607,2369,2238,51.42,48.57,2
178910,VN,VRANCEA,PAULEȘTI,1136,883,253,77.72,22.27,2
177236,VN,VRANCEA,PĂUNEȘTI,2620,1109,1511,42.32,57.67,1
178894,VN,VRANCEA,PLOSCUȚENI,1306,924,382,70.75,29.24,2
177263,VN,VRANCEA,POIANA CRISTEI,1334,874,460,65.51,34.48,2
178901,VN,VRANCEA,POPEȘTI,1413,693,720,49.04,50.95,1
177352,VN,VRANCEA,PUFEȘTI,1947,979,968,50.28,49.71,2
177405,VN,VRANCEA,RĂCOASA,1663,823,840,49.48,50.51,1
178956,VN,VRANCEA,RĂSTOACA,1267,647,620,51.06,48.93,2
177469,VN,VRANCEA,REGHIU,1171,712,459,60.80,39.19,2
177557,VN,VRANCEA,RUGINEȘTI,1878,1093,785,58.20,41.79,2
177600,VN,VRANCEA,SIHLEA,2233,1528,705,68.42,31.57,2
177655,VN,VRANCEA,SLOBOZIA BRADULUI,2478,1027,1451,41.44,58.55,1
177726,VN,VRANCEA,SLOBOZIA CIORĂȘTI,1148,807,341,70.29,29.70,2
177762,VN,VRANCEA,SOVEJA,1309,864,445,66.00,33.99,2
178965,VN,VRANCEA,SPULBER,670,464,206,69.25,30.74,2
177799,VN,VRANCEA,STRĂOANE,1781,1174,607,65.91,34.08,2
177842,VN,VRANCEA,SURAIA,2540,1136,1404,44.72,55.27,1
178046,VN,VRANCEA,TÂMBOEȘTI,1376,881,495,64.02,35.97,2
177879,VN,VRANCEA,TĂNĂSOAIA,1247,910,337,72.97,27.02,2
177986,VN,VRANCEA,TĂTĂRANU,2329,1411,918,60.58,39.41,2
178180,VN,VRANCEA,ȚIFEȘTI,2353,973,1380,41.35,58.64,1
178117,VN,VRANCEA,TULNICI,2149,1253,896,58.30,41.69,2
178279,VN,VRANCEA,URECHEȘTI,1479,543,936,36.71,63.28,1
178313,VN,VRANCEA,VALEA SĂRII,1063,594,469,55.87,44.12,2
178607,VN,VRANCEA,VÂNĂTORI,3102,1413,1689,45.55,54.44,1
178689,VN,VRANCEA,VÂRTEȘCOIU,1702,1151,551,67.62,32.37,2
178377,VN,VRANCEA,VIDRA,3374,1964,1410,58.20,41.79,2
178475,VN,VRANCEA,VINTILEASCA,1054,768,286,72.86,27.13,2
178545,VN,VRANCEA,VIZANTEA-LIVEZI,1752,717,1035,40.92,59.07,1
178750,VN,VRANCEA,VRÂNCIOAIA,1267,909,358,71.74,28.25,2
178821,VN,VRANCEA,VULTURU,3394,2267,1127,66.79,33.20,2
